Russian	Predicted	Truth
а когда дед мороз вернуться домой маленький дед мороз приходить к главный и сказать а я то вон в лес тоже подарок раздавать	когда и а а а вон я тоже вернуться	indx дед.мороз clf clf.группа clf.переместить домой clf clf.группа clf.переместить дед.мороз маленький встретить приходить обращение главный 1ps был лес подарок clf clf.перечислять
а мачеха лишать я весь радость	радость лишать я а весь я матче	мама второй 3ps все радость давать 1ps ноль
зачем я хотеть изменять свой привычка тратить и начинать копить	хотеть тратить я и изменять свой привычка начинать зачем	зачем желание изменение все4 привычка тратить все4 желание именение привычка свой изменение тратить и копить думать
оказываться впервые это появляться в америка	появляться оказываться это впервые америка в	америка есть poss 3ps 3ps рассказ 1ps интересный америка первый прогресс
я вчера не стирать белье	стирать я вчера не белье	1ps вчера стирать <dact> не был
она один за другой скидывать с себя туфля и прямо в один чулок подходить к дверь и у я от радость заколотиться сердце	я и и и и в себя закалываться я от	обувь2 убирать чулок бродить дверь 1ps думать радость 3ps скоро открывать.дверь сейчас скоро радость сердцебиение
тогда как	тогда как тогда как	<dact> дальше <dact>
заиграть первый луч солнце а друг уже у река	первый уже а река луч солнце друг у заигрывать река	утро солнце друг уже рядом река
я весь устраивать я быть интересно учиться и скоро я уже сам начало выполнять даже сложный заказ	быстро я я уже просто я начинать выполнять сложный учиться	1ps спокойный2 1ps был интересный учиться и время clf clf.время clf.идет 1ps уже сам2 получать даже сложный 3ps заказывать 1ps
мы отдыхать	мы отдыхеть	мы отдых
нигде	нигде где	<dact>
почему	почему почему	почему
он уметь кататься на лыжа	на лыжа он уметь кататься	3ps знать лыжи
я не понимать то ли она плакать то ли смеяться	понимать я то не смеяться ли она ли плакать ли	1ps видеть не понимать 3ps плакать или смеяться
в общий немного эмоционально получаться	общий в эмоционально получаться немного	результат эмоция давать
сегодня мы разбирать ещ один опасный ситуация связанный с дыхание	дыхание сегодня разбирать связывать еще опасный ситуация один с мы	сегодня объяснять ещё <nums> опасность связать дышать
ты я не только разозлить но еще и расстраивать	разозлить но расстраивать не я еще и только я раз	2ps н-е только2 злость 1ps и плюс 1ps депрессия
хорошо радоваться тогда и дочь быстро поправляться	быстро дочь тогда радоваться хорошо и поправка и дочь	пусть радоваться влиять 3ps дочь быстро здоровый будет
например в россия быть свой традиция	быть традиция свой например россия в	группа пример россия есть свой традиция
мочь быть и я вы помогать	я помогать быть и мочь вы	мочь быть говорить 1ps помощь
сейчас мочь даже слышно в микрофон	даже в слышно мочь сейчас микрофон яже	мочь быть немного слышать микрофон
кролик увидеть в цветок фея	увидеть в цветок кролик фея	кролик что цветок и <dact>
он долго плыть и замечать вдали берег	он берег плыть и замечать долго подавать	долго clf clf.плыть clf.на clf.бочка замечать видеть indx clf clf.берег
жаль что я туда вс равно не попадать	попадать туда я жаль что я вс равный не	жалость 1ps тоже indx попадать невозможный
не весь похоже понимать как это делать для себя а не для другой	делать для похоже другой как не для не для себя понимать	себе делать похоже все не понимать как 1ps для 3ps делать
он отравляться	отравляться он	яд
много гриб собирать мальчик в лесной часто	много часто лесной собирать мальчик в гриб гриб	много гриб собирать2 лес
без видео плохо но ладно я вы рассказывать сам история про англия	я плохо но история про сам нормально вы рассказывать без я про но	видео2 indx плохой 1ps 2ps 1ps рассказывать 2ps англия indx <dact>
он замечательно п к печение любой форма например в вид зв здочка лочек	форма вид в любой например замечательно к он здрочка печение лочка	это 3ps идеальный печь печенье <dact> вкус любой это 3ps уметь форма звезда ель разный pl
это глагол прилагательное	прилагательный этот глагол	<dact> <dact>
к себя он приглашать я бояться но однажды он напрашиваться ко я на чай и увидеть мой условие жизнь предлагать пожениться и переезжать к он	напрашиваться я предлагать он и к он и пожениться к он	1ps себя дом страшный 1ps приглашать 3ps н-о вдруг о-н 3ps обратиться 1ps imp чай пить о-н 3ps видеть 1ps poss 1ps условие2 все жизнь видеть imp жениться и переезд к 3ps
и вы обязательно нужно давать ответ рассказывать	давать и рассказывать нужно обязательно ответ вы	2ps pl обязательно нужда ответ pl рассказ pl ответ pl
когда мы отжимать волос вода на они оставаться	оставаться когда отжимать вода на они мы волос	н-о 1ps жать вода clf clf.вода clf.на clf.волосах что необходимость вода оставаться indx есть
хотеть продолжать тема созависимость пренебрежение себя	продолжать себя сонезависимость хотеть тема пренебрежение себя	привет
пищевой волокно связывать большой количество вода в кишечник превращать е в гель который затрудянуть усвоение углевод что сказываться на снижение уровень колебание сахар в кровь	е превращать в колебание большой в волокно гель превраща	еда волокна успех связь3 только2 больше жидкий вода кишечник успех изменять <dact> и успех <dact> indx конец и успех 3ps давать 1ps уменьшать2 уровень колебание кровь
в строчка выбирать вариант или	строчка выбирать вариант в или	строчка связать <nums> 2ps выбрать <nums> ответ
когда появляться проблема нужно быстро придумывать как они решать	быстро решать придумывать появляться как проблема когда нужно они решать	проблема2 появляться быстро решать что придумывать быстро решать
потом я становиться искать какой-нибудь конкурс и наш л один который проводить среди слышать проводиться он два или три день в общий сложность	слышать проводить и сложность я и два потом он проводить	1ps искать соревнование indx говорить соревнование 1ps все включено это все включено говорить соревнование <nums> день <nums> день <nums> факт2 indx дактилировать
у я быть я крутой у я быть связь	я быть связь я крутой я у быть я у	1ps мочь круто 1ps связь2 есть
я тоже хотеть ходить на бал	хотеть тоже я ходить балтика на	1ps тоже желание посещать pl clf clf.пышная clf.юбка танцевать <dact>
мы знать это животное по мультфильм оно выглядеть так мило что мы и не думать о то что оно опасный а оно опасный	знать оно оно опасный а оно что знать выглядеть и оно так	знать вы животное2 мультфильм2 интересный clf clf.милая clf.пушистая clf.мордочка милый 3ps думать неопасный н-о 3ps опасный есть
наш организация существовать с го год	существовать год наш го организация с организация наш	это poss 1ps pl организация существовать уже <nums> год
видеть по-разному	видеть по-разному	видеть разный
второй шаг	второй шаг	второй шаг <dact>
что вообще мочь сделать мы счастливый легко и быстро	быстро что быстро сделать счастливый вообще мочь и быстро мы	как вообще что влиять на 1ps мочь мы делать счастье очень легко2 быстро2
подруга рассказывать о свой проблема я тоже поделиться свой	рассказывать тоже я свой поделиться о проблема подруга тоже свой	друг 3ps рассказывать 1ps собственность проблема2 3ps рассказывать 1ps 1ps тоже 1ps рассказывать 3ps делить
хорошо	хорошо	хорошо
немного зима посмотреть и лето быть	зима немного и посмотреть быть лето зима	немного зима смотреть2 лето есть
хитрый	глупый	хитрый
номер три это животное который называться древолаз	который номер животное этот называться три который леволаз образ	еще есть животное2 назвать <dact>
а человек видеть мир по-разному	видеть мир человек по-разному а	а человек pl видеть различный
в год в павловск построить ленинградский восстановительный центр	год в павловск ленинградский восстановительный построить в центр	смотреть <nums> год <nums> год павловск <dact> indx стройка clf ленинград восстанавливать центр
мой бабушка не любить гулять ночь	гулять ночь мой любить не бабушка	poss 1ps бабушка2 не.любить гулять ночь
нет так нет ну и ладно	нет и нет ну так и нет нормально нет ну	нет2 так нет2 н-у
такой человек называть элита	человек такой элита называть	новый все человек pl назвать <dact>
сейчас я видеть весь больше и больше небольшой команда который пытаться что-то делать как-то развиваться	видеть развиваться пытаться делать я и команда сейчас много я	сейчас всё 1ps видеть больше маленький3 команда и-п сам2 достигать так развивать
ребенок весь понимать	ребенок весь понимать	все дети понимать2.наизусть
няня весь собирать и выбрасывать а мальчик давать новый белый с блестящий мех	белый собирать новый и а давать няня белый выбрасыва	няня2 ладно собирать2 выбросить2 мальчик давать новый белый мех блестящий
для кто-то нужно утяжеление для кто-то чтобы быть разглаживание	для утяжеление кто-то для для чтобы быть нужно	<dact> кто тяжелый clf clf.волосы clf.тяжелые <dact> кто clf clf.волосы clf.гладкие clf clf.волосы clf.лежат clf clf.волосы что был
начальник говорить мы же готовый он взять у мы быть такой рабочий место но по факт человек с инвалидность никогда не пойд т на это место	начальник никогда пойти готовый но рабочий на человек взять быть	начальник говорить мы готовый принять такой место у 1ps есть приглашать но п-о факт2 никогда это место инвалид вступить.не
ты должный позвонить мама а то она будет беспокоиться	она быть беспокоиться то позвонить должный а мама то а	2ps должен мама 1ps звонить.по.телефону 3ps 3ps волнение будет
я сидеть в свой комната учиться не пойти но жить на что-то надо быть	быть на жить но я комната в пойти не надо что-то си	всегда2 сидеть комната учиться нет нужно деньги жизнь
я обращаться и в другой место например в вога и там я тоже оформлять письмо поддержка такой образ уже они у я быть несколько	и и обращаться я я и место я такой	другой pl посещаемость надеяться indx и 1ps тоже <dact> 1ps обращаться <dact> тоже indx 3ps поддерживать 1ps печать 1ps повезло clf clf.складывать clf.письма clf.вместе уже
я не нравиться яркий одежда	не яркий я нравиться одежда	1ps яркий светлый одежда2 не нравиться
глупый	глупый	дурак
сейчас для наш человек это возможность действительно заниматься любимый дело	сейчас это возможность для действительно человек заниматься дело наш любимый	сейчас мы человек pl это возможность действительно работа любить работа
если педагог видеть что он разговаривать хорошо и весь понимать то он без проблема идти в отделение и учиться год	и видеть и хорошо отделение если и и видеть в	если смотреть ребенок разговаривать2 хорошо понимать все <nums> подразделение год <nums> учить2 не
потом домой приходить и мама просить еще урок проводить	просить потом проводить домой и еще просить урок приходить мама	домой мама еще считать3 уроки
например двое мой ребенок говорить на жестовый язык	говорить язык мой жестовый ребенок двое например на	дополнение пример poss 1ps дети <nums> глухой не говорить на жестовом языке
почему у мы в россия это не популярный	популярный россия почему у не это в мы это	1ps россия популярный нет2 почему
журналист просто бер т этот новость и публиковать на сайт с красивый картинка	этот и на публиковать т просто новость сайт с красивый журналист картинка	1ps взять публиковать 1ps отправлять 3ps <dact> красивый картина
я жить в краснодарский край	жить край краснодарский я в	1ps жить кавказ место краснодар территория
нужно изучать основа чтобы иметь общий пердставление о они чтобы экскурсовод мочь об этоя рассказывать	чтобы рассказывать о они нужно общий рассказывать чтобы пердставление	основной2 нужда изучать что общий получать воображение 3ps pl рассказ indx будет экскурсия человек экскурсия человек
я вы совсем не знать но я кажется готовый смотреть в ваш глаз вечность	кажется знать смотреть но я я совсем ваш в не готовый глаз	дорогой девочка знакомый не 1ps 2ps совсем не знать н-о 1ps казаться 1ps poss 2ps глаз pl готовый зрительный.контакт вечность
а этот мужчина быть сантехник который чинить прорыв канализация и который обливать дерьмо тома давать он халат муж и разрешать подождать пока он привозить чистый вещь	который и который он привозить и этот разрешать вещь	а мужчина2 это кто сантехник <dact> сантехник 1ps исправлять 3ps туалет канализация clf clf.облило clf.из clf.канализации грязь туалет <dact> для халат муж и зафиксировать пока приносить чистый poss 3ps одежда3
скоро быть праздник	скоро быть праздник	скоро будет праздник
пока спасатель ехать мальчик сидеть рядом и следить	спасатель рядом следить мальчик ехать пока сидеть и	пока спасать clf clf.человек clf.прийти 3ps мальчик рядом следить н-о жалость
весь целый весь пока	целое пока весь весь	воздушный.поцелуй аплодисменты
усердный	усердный	усердно.трудиться
открываться дверь	открываться дверь	открывать.дверь
он мочь бить себя по грудь или по стол пытаться показывать что он плохо и нужный помощь	и он себя пытаться показывать по стол мочь бить помощь	получаться 3ps clf clf.хлопать clf.по clf.грудь clf clf.хлопать clf.по clf.стол тоже показывать все 3ps помогать 1ps тоже плохой
представлять что инициативный группа хотеть разрабатывать проект который помогать избавляться от этот проблема и не давать она развиваться	инициативный разрабатывать группа этот помогать который что не проект развиваться	ладно группа гап делать indx проект проблема2 убирать живот развитие нет проблема убирать
жертва это когда вс что ты делать ты делать в ущерб себя	когда делать в ущерб делать себя это все что делать в	<dact> называть <dact> что делать 1ps делать отдавать.себя себе думать нет
медвежонок плыть на льдина	медвежонок на ледина плыть	медведь маленький3 clf clf.круглый clf.предмет clf.плыть clf clf.толстый clf.лед <dact> clf clf.запрыгнуть clf clf.на clf.четырех clf.лапах плыть
я этот никто не учить	этот я не никто учить	1ps научить 1ps никто
например дма она заставлять она делать самый тяжелый работая	тяжелый работать заставлять она дма самый например она делать	например дом самый сложный тяжелый труд clf clf.сесть clf.на clf.шею
на улица быть тепло и мальчик хотеть пойти гулять однако начинаться дождь	и дождь однако пойти гулять на улица быть дождь мальчик	indx смотреть улица теплота мальчик желание выходить гулять начать дождь
смотреть на вы	вы на смотреть ось	смотреть 2ps
что там	там что там	что indx
он облизываться	он обливать	вкус облизывать
идентичность я глухой и ты глухой	глухой глухой я идентичность глухой и глухой я ты глухой	следующий2 яг 1ps одинаковый 2ps 1ps глухой кровь2 2ps глухой 1ps одинаковый 2ps
если весь быть копить не нужно откладывать на всякий случай	случай всякий копить откладывать если на не весь нужно бы	копить 1ps копить не.нужно все есть это запас вклад
сура в адаптис плохой перевод в субтитр такой замечание	субтитр в в такой плохой перевод сур адаптис замечание кардитр	<dact> <dact> плохой субтитры перевод плохой замечание2
у я нет сила	у нет сила я я	1ps сила дефицит
этот верхний пункт сокращать но затратный ресурс быть всегда	этот всегда быть сокращать но пункт верхний всегда ресурс затратный это	это clf clf.деньги clf.уменьшаться <nums> расходы <dact> всегда постоянный тратить pl
здесь жить дружно поколение старший бабушка и дедушка средний мама и папа и младший ребенок катя и антон	и антон жить и и и и и сын з	indx дружба жить вместе <nums> поколение старший бабушка2 дедушка второй мама папа третий младший дети <dact> <dact>
я должный завершать еще пара важный дело пока	еще важный пока я должный дело завершать пара пока	1ps должен конец <nums> важный дело пока
понятно	понятно	понятый
сегодня мы продолжать разбирать программа slim	продолжать разбирать мы сегодня программа slim	сегодня2 продолжать <nums> исследовать <nums> д <dact>
но сначала давать разбираться как усваиваться пища	разбираться но пища усваиваться сначала давать как разбираться	н-о исследовать <dact> 1ps еда воспринимать <dact>
рассказывать еще	рассказывать еще еще	жестовый язык кто еще был рассказывать
терять	терять	потерять2
он приносить одеяло из дом и накрывать собака обращаться к взрослый за помощь	и взрослый приносить дом собака обращаться к дом из за одеяло	одеяло дом clf clf.взять clf.принести одеяло обращаться взрослый помогать 3ps 3ps
даже мэр город приезжать чтобы успокаивать мальчик	мэр приезжать успокаивать даже город чтобы приезжать мальчик успокаивать	и даже <dact> город поехать гость 3ps 3ps успокоить 3ps 3ps pl
например компьютер ноутбук проектор стул стол и всякий вещь	и всякий вещь например стол кресло проектор компьютер всякий	пример компьютер ноутбук проектор мелочь стул pl стол был
здравствовать	здравствовать	здравствуйте
сейчас я объяснять как и что	объяснять я и сейчас как что я	1ps сегодня2 1ps рассказывать 2ps что <dact> это
она просыпаться и она быть очень тесно	она очень быть она и просыпаться тесно она	проснуться и тесный был нормальный тесный
идти дождь и мы решать оставаться дом и посмотреть фильм	оставаться решать и посмотреть дом идти дождь и фильм оставаться мы	дождь 1ps думать решать оставаться дом и смотреть2 фильм2
весь что она удаваться находить это работа дворник в соседний двор но больший она и не нужно быть главное что хватать платить за квартира а на ехать она надо быть совсем немного потому что она почти ничто не есть и похудеть до неузнаваемость	и квартира и быть находить соседний и а ни	и все что мочь2 успех только2 работать дворник сосед indx территория н-о дворник достаточно квартира платить есть деньги еда должен нет много <dact> чуть-чуть еда нет ничего2 худеть видеть лицо узнать нет
кто она резать	она резать кто	3ps кто 3ps разрезать 1ps
что вообще представлять себя этот организация и зачем она нужный	себя представлять зачем нужный организация вообще что этот она и	это организация здесь для что
видимо становиться больше сажать культура и из-за большой количество урожай он становиться собираться поздно	большой становиться собираться урожай культура поздно и из-за большой	больше clf clf.сажать clf.в clf.землю урожай собирать2 выше начинать позже собирать2
в это место очень много турист благодаря то что здесь много исторический здание	благодаря здесь много этот очень исторический в много место что турист очень	это место много 3ps приезжать путешествие <dact> почему это место2 много исторический clf музей разный
семья это много домашний работа	много семья домашний это работать хорошо	семья это много дом работать
но я никогда не встречать	встречать никогда но не я я	1ps встречаться никогда
потому что нет общение нет любовь и понимание и он быть просто как собачка это очень страшно а у тот трое быть семья любовь общение и вот это реально до мурашки	и и очень просто собачка вот и нет а быть	общение ноль2 любовь ноль2 обнимать ноль2 игнорировать2 одинаковый собака2 clf clf.собака clf.прислушивается папа иса indx боль 3ps pl общение это 3ps pl 3ps pl спасибо общение делить думать сохранение понимать спасибо папа папа 3ps clf clf.мурашки clf.по clf.коже
в ноябрь будет год как я официально работать переводчик	переводчик быть год ноябрь официально работать я в как я	ноябрь официальный 1ps работать2 переводчик уже <nums> год
я ждать твой звонок но ты я не позвонить	ждать но я звонок не я твой позвонить он	1ps ждать2 когда2 3ps звонить.по.телефону 1ps 2ps тоже 3ps звонить.по.телефону 1ps нет2
рядом с печень желчный пузырь который удерживать желчь до необходимый момент	до удерживать который желчь момент желчный пузырь желчный с необходимый	печень рядом <dact> <dact> clf clf.желчный clf.пузырь indx <dact> действие оставить нужно clf clf.желчь clf.убрать
лев лишь рассмеяться	лев лишь рассмеяться	смеяться3 лев смеяться смеяться3
интересно	интересный	интересный
я быстро получать обещать жилье но это быть маленький комнатка в коммуналка где сосед ввергать в шок при первый же встреча	где я ввергать в встреча обещать быстро но при сосед жилье	1ps быстрый получать дом это был маленький3 комната сосед pl квартира сосед pl все сумасшедший3 1ps взглянуть
осаня начинаться в конец октябрь в ноябрь или декабрь	конец декабрь начинаться октябрь в декабрь в ноябрь осада ко	всегда осень2 начинать октябрь последний3 ноябрь декабрь всегда изменить.направление
интересно так	так интересно так	интересный так
второй вариант частично да частично нет	вариант частично второй частично нет да да второй	второй половина да половина <dact> слабый
ничто из еда нет	нет еда из ничто еб	еда indx pl ноль
я любить голубой цвет а мой сестра ненавидеть он	любить мой голубой ненавидеть я а цвет он сестра я	poss 1ps любить голубой цвет голубой poss 1ps сестра ненавидеть2
переводчик слушать речь и переводить на жестовый язык	жестовый переводчик на и переводить переводчик слушать язык речь речь перевод	переводчик слушать 3ps речь 1ps 2ps 1ps рассказывать.на.ржя рассказывать переводить рассказывать переводить
если бы у мы в школа россия знать что глухой ребенок из семья глухой свободно говорить на жестовый язык и он учить бы переход с жестовый язык на русский то в школа бы привыкать обучать на жестовый и у ребенок быть бы грамотный русский язык	быть язык жестовый русский быть и быть на у говорить и	что если б-ы poss 1ps россия площадь б-ы школа вокруг знать ребенок глухой семья глухой говорить на жестовом языке <dact> переезд школа б-ы привычка обучать2 жестовый язык поменять грамотность poss 3ps русский язык
веселый	веселый	веселый
первый вариант принимать такой как быть	вариант первый такой как быть принимать	первый принимать такой2 как есть
а если с реб нком в семья общаться при помощь устный речь а жестовый язык считать ненужный это не совсем CODA	а речь жестовый если не а Cod это не а помощь	а если есть кто дети2 мама семья глухой ребёнок дети2 родиться слышащий говорить2 жестовый.язык не.нужно говорить2 беседовать poss 1ps кода indx нет indx
этот чувство доброта и любовь появляться в человек сам по себя	появляться любовь по чувство сам доброта в человек себя этот и	чувство добрый любовь появляться человек автоматический согласие
когда я забеременеть то так же работать до последний а потом еще и на дом брать подработка	когда потом работать я дом еще и а так до на	когда2 1ps беременность 1ps работать до <dact> приближаться плюс дом получать pl работать
как становиться эмоциональный энергичный воодушевлять свой жизнь	воодушевлять свой энергичный жизнь становиться как эмоциональный выражательный	как стоять эмоция энергия воодушевление свой жизнь как
год он лечиться и выздоравливать	выдоравливать и лечиться он год	год <nums> лечение заболеть здоровый
ты знать кто я	знать кто я я мы	2ps знать кто 1ps
также природа выделять жир роль запасной энергоноситель т е поступать жир пойти на образование энергия но только в случай крайний энергодефицит	роль также случай т энергодефицит поступать на только т	успех и плюс природа 3ps давать 1ps электричество <dact> <dact> indx 3ps отправлять 1ps н-а основывать электричество только2 если 1ps электричество недоставать
заболевать	заболевать	заболеть
дедушка помогать антон они вместе записывать весь история семья	антон весь история записывать вместе семья помогать дедушка они	дедушка 1ps помогать 3ps <dact> вместе писать записать все история семья
на это мероприятие приглашаться весь дама и королева который хотеть повеселиться и отдыхать вместе со я принц это королевство сын король и наследник престол	принц наследник принц и принц и принц я принц и со приглашаться	это мероприятие праздник приглашать все девочка кто мечтать желание веселиться отдых 1ps вместе 3ps 1ps принц руководить это территория сын король наследство дать 1ps престол
дотащить он мешок в лес и раздавать подарок весь животное они очень обрадоваться	обрадоваться очень раздавать весь лес они подарок он и мешок	clf clf.принести indx лес и подарок pl каждый животное2 подарок все возбуждение
на концерт	на концерт	зал
он лежать мертвый в высокий трава и в сердце у он быть острый шип	лежать он и у в мертвый он высокий шипов быть	о-н смерть трава clf clf.птица clf.упала clf.в clf.траву сердце птица2 indx был острый шип
женщина любить носить шуба они тоже защищать от ветер	от защищать они носить тоже любить ветер женщина шуба буш	женщина pl любить носить шуба2 тоже включать ветер защита
снег растаивать потому что выглядывать солнце	что потому снег выпаглядеть солнце растаивать	снег таять почему солнце
этот конкурс следующий конкурс увидеть принимать участие	этот следующий конкурс принимать участие увидеть конкурс плакат участие	indx соревнование следующий соревнование заметить3 это 2ps стараться принимать участие
если вы решать участвовать в конкурс быть бы хорошо если бы у вы уже быть готовый проект потому что так легко будет о н м рассказывать доказывать он нужность	быть если о уже готовый быть быть хорошо если бы	что любой соревнование принимающий участие желание б-ы проект все готовый легкий принимающий участие проект есть легкий принимающий участие 1ps рассказывать 2ps доказывать легкий
этот организация только для слышать ребенок CODA	этот организация слышать для только CO ребенок для	indx это организация только <dact> дети2 слышащий кода
но помнить что масло бывать опасный	что но бывать опасный масло помнить	н-о помнить что если масло бывает это опасный
грубый	грубый	грубый
раз ты просить я подождать	раз поджигать просить я поджигать раз я ты просить	2ps просить 1ps ждать
наш сми за вс в то число и за размещение публикация хотеть получать деньги	за размещение и за деньги в хотеть публикация число получать м	у 1ps pl <dact> желание деньги нужда публиковать новости так ведомый деньги
самостоятельно выбирать ответ пожалуйста	выбирать самостоятельно ответ пожалуйста	сам2 нажать отвечать пожалуйста
благодаря сплоченность весь команда они выигрывать	благодаря команда выигрывать весь сплоченность они	спасибо команда дружба 3ps pl найти
и слышать и глухой приходить и организовывать свой группа	и и и приходить слышать организовывать глухой группа сво	приходить pl слышащий толпа группа pl свой группа глухой
опытный	опытный	опытный
вс весь пока	все пока вс весь	все пока
ждать ваш звонок	ваш звонок ждать	ждать2 ваш звонить.по.видеосвязи
крепкий	крепкий	твердый
например здесь в россия мы открывать свой организация код но мы выбирать русскоязычный название слышать ребенок в семья глухой	организация здесь слышать название россия например в в но организация ребен	пример 1ps здесь россия 1ps создавать2 кода а факт2 clf clf.появиться называть <dact> poss 3ps россия 1ps называть слышащий слышать дети2 семья глухой
еще бывать по-другому при полный блокада дыхательный путь ситуация тяжелый человек не мочь говорить кашлять и дышать т е полный тишина	еще и е дыхательный тяжелый еще не путь говорить	еще по-другому если полный indx останавливаться это тяжелый человек говорить не.мочь.сделать кашлять2 не мочь дышать не мочь 1ps молчать тихий
я быть сильно тосковать когда ты не становиться	становиться когда сильно не я быть тосковать я тосковать	отвечать 1ps будет очень сильный скучать без вы
ставить лайк и деваться этот видео если оно ты понравиться	видео если ставить лайк оно этот деваться и понравиться если	ставить.лайк и делиться это видео если 2ps нравиться
я повезти что проект быть выполнять давно	что вывозить быть выполнять давно я проект я	1ps повезло и проект давно был выполнять
кто не видеть это видео в описание будет ссылка на это он и ссылка на плейлист урок остеопатия там вы находить очень много полезный и интересный	и плейлист находить и кто очень видеть полезный ссылка	кто когда2 видеть не видео2 будет indx копировать копировать о писать <dact> это урок <dact> мочь видеть и мочь успех кто интересный множественный очень полезный
нечего дом сидеть с малыш я сам справляться а ты быть прибегать и кормить он	и сам я он прибегать справляться а кормить быть нечего	бесплатный прохлада хватит 1ps сам2 ребенок 2ps будет приходить и кормить ребенок
специальность быть весь тот же программирование	же быть специальность программирование тот весь	п-о специальность то.же.самое направление компьютер
только сам без мой подсказка	сам без мой подсказка сам только прочее	н-о сам2 без poss 1ps подсказывать
этот процесс нарастать и человек у который быть килограмм лишний начинать набирать вес ещ быстро словно из воздух	килограмм процесс и у быть начинать человек лишний начинать быстро набира	успех у 3ps человек это есть лишний вес пример <nums> к-г лишний успех еще больше pl похоже ничего3 похоже больше pl успех
в нет год быть школа грантовый проектирование да	нет год школа в проектирование быть давать грантовый	<nums> ш школа г проект п проект да indx
у мой брат нет жена	брат у нет мой жена  брат	poss 1ps брат жена нет2
начинать учить жестовый язык	начинать язык жестовый учить	начать учить3 жестовый язык
и я непонятно почему вдруг опять чихнуть изо весь сила с какой-то даже подвывание чихнуть вот так апчхи уу	и я так какой-то сила чихнуть вот сила оп	1ps новый 1ps зачем не понимать 1ps <dact> <dact>
зима здесь очень холодно особенно в январь начало февраль	холодно здесь зима февраль особенно очень начинать февраль в	зима очень заморозить январь февраль срок.между
но получаться так что я глухой я же не смочь быть педагог	смочь быть так я глухой получаться я не но так что я	успех вот 1ps глухой преподавание не.мочь 1ps преподавание
и улучшать углеводный обмен а именно чувствительность рецептор клетка инсулин они снижать аппетит и тяга к сладкий поэтому вечерний капсула рекомендоваться принимать за минута до еда	и именно а и принимать и а азот	еще лучше2 <dact> clf clf.организм clf.процесс и чувство <dact> клетка2 <dact> indx ниже еда еще сладкий не.хотеть2 вечер капсула2 советовать з-а <nums> минута до будет еда
мы с вы рано не встречаться	встречаться вы не рано вы с может мы	мы.вдвоем раньше встречаться был не был
так сейчас	так сейчас так	сейчас
там уже быть показываться другой новость	быть там другой показываться новость уже	другой новость clf clf.новость clf.подниматься уже
и тогда ваш жизнь обязателньо будет счастливый	ваш жизнь тогда счастливый обязателньо быть и	даже poss 2ps жизнь будет обязательный счастье
я не нравиться этот футболка то быть я не быть она покупать	быть не она этот я не нравиться покупать быть футболка то	1ps футболка не нравиться тоже покупать не будет
наказывать	наказывать	наказание
следующий одинаковый мировоззрение и восприятие мир	мировоззрение мир одинаковый восприятие следующий и мировоззрение	следующий2 мировоззрение восприятие думать мнение pl о мир2 у.всех.одинаково
быть момент когда я нужно быть находить музей и я обращаться к наставник а они находить нужный человек и обменять мы номер	когда и а быть обращаться они нужно и находить	1ps недоставать 1ps обратиться пожалуйста искать <dact> был 1ps искать нужно это 1ps обратиться пожалуйста <dact> успех 3ps хороший 3ps искать успех и обмен poss 3ps clf clf.сводить clf.людей
а кролик сидеть в мешок переживать вспоминать хороший время как играть с мальчик и общаться с лощадь	с вспоминать и играть в с ребенок а  площадь а	indx <dact> clf clf.куча кролик переживать помнить был хорошо время мальчик беседовать игра indx лошадь был общаться
какой причина	причина какой	причина какой
привет я звать мир	мир звать привет я	приветствовать 1ps имя <dact>
этот механизм будет работать только если мы взять грамм белок грамм жир из жировой запас и грамм глюкоза из гликоген	грамм грамм грамм грамм только и работать быть если вз	успех <dact> <nums> грамм indx <dact> <dact> и-з <dact> выбирать
и чем	чем и	<dact>
у я нет никакой одежда	у нет никакой я одежда	1ps одежда2 нет3 нет2
здесь пособие не выдавать	выдавать здесь не пособие	пособие деньги 1ps помогать 3ps давать 1ps нет2
твердый	твердый	твердый2
мочь быть у вы другой причина я не знать у весь по свой	другой у причина у знать мочь не быть я по свой у	мочь быть у 2ps pl другой причина indx не.знать2 свой pl
тихий	тихий	тихий
нога муж лечить несколько месяц а потом он вернуться домой к нормальный жизнь	к домой потом нога а нормальный месяц вернуться жизнь несколько леч	indx 1ps исправлять 3ps некоторый месяц а проходить о-н возвращаться домой к обычный жизнь
он постучаться в последний дом и прокричать впускать отдыхать дорожный человек	последний прокричать дом человек впускать и в он прокричать в лет	indx последний смотреть стучать2 кричать выпуск дорога2 человек отдых
мы приезжать сюда с цель увидеть храм	увидеть приезжать сюда цель приезжать храм с храм с при	1ps приезжать зачем что видеть церковь <dact> дворец
если вы сомневаться нужно или не нужно то хорошо добавлять бальзам ничто страшный не будет	хорошо добавлять ничто не надо если не хорошо быть то страшный	если вы сомневаться необходимость не.нужно улучшать <dact> добавлять можно страх не иметь
я можно находить в Instagram во вконтакте	во можно вконтакте находить я в я в	можно находить 1ps instagram indx можно вконтакте 1ps
мокрый	мокрый	мокрый
мы брать разный проект к пример взять один проект и заплатить человек взять второй и третий заплатить тоже	брать второй и к проект заплатить разный взять первый заплатить	проект другой получать pl indx пример indx проект indx зарплата 1ps 3ps человек indx зарплата 1ps 3ps indx зарплата 1ps 3ps
весь что у вы в жизнь происходить будет меняться	происходить у меняться быть вы жизнь что вы весь в	все что у 2ps pl случай pl жизнь будет изменить
в год весь немного поутихнуть и решать проводить II съезд глухой	год съезд немного решать и проводить поутидать весь в глу	<nums> год чуть-чуть успокоить и <nums> год желание проводить второй форум второй форум желание проводить clf clf.люди clf.собираются clf.в clf.одном clf.месте н-о indx <dact> indx
мой друг захотеть перечитывать сказка владимир григорьевич сутеев	перечитывать владимир сутеев друг мой птичий сказка хотеев	poss 1ps друг желание читать дизайн <dact> <dact> <dact>
я должный уметь побеждать в война	война в я должный побеждать уметь	1ps обязанность качественный стратегия что война победа
там рассматривать мой проект спрашивать чем помогать и помогать я стараться участвовать в любой соревнование в новосибирск и другой город буквально в любой	в и в и в я город другой соревнование стараться в проект	clf clf.рассматривать clf.проект что нужно 1ps просить перечислять 1ps давать 2ps стараться любой соревнование что здесь новосибирск традиция город некоторый тоже традиция это indx соревнование успех принимающий участие
если месяц назад то на самоизоляция а если месяц или тогда как	назад или самоизоляция тогда месяц месяц то как если на то а если	<nums> месяц раньше <nums> месяц т-о самоизоляция если месяц <nums> месяц 3 <dact>
когда льдина уже почти растаивать он увидеть в вода деревянный бочка	увидеть почти уже растаивать когда он в вода бочка ледина дерев	когда быстрый таять clf clf.льдина таять медведь замечать вода indx деревянный бочка clf clf.бочка clf.плывет
например нужно или нет учить характер общение с ребенок	общение например ребенок учить нужно или нет характер с	например характер общаться с ребенок необходимость не.нужно
поэтому должный быть отдельный факультет для тот кто хотеть продолжать качественно учиться с переводчик	продолжать отдельный должный кто тот быть хотеть качество переводчик для	поэтому должен быть отдельный <dact> 3ps кто желание продолжать качественный clf clf.человек clf.приходить переводчик преподавание переводчик indx
семья это счастие любовь и удача	семья удача любовь счастие и любовь этот	семья это счастье любить счастье удача
видео мы отправлять несколько человек давать он весь посмотреть	несколько он отправлять видео посмотреть давать человек весь мы	видео отправлять.сообщение pl все просить смотреть смотреть2
когда в школа глухой работать переводчик то они согласный приходить	когда приходить они согласный глухой работать переводчик то школа в они	школа глухой работать есть переводчик 1ps приходить гап
наш настроение легко портиться из-за политика из-за другой ситуация отношение	настроение отношение из-за настроение из-за другой наш легко ситуация порт	мы очень легко грустить влиять 1ps страдать политика другой случай pl
на сегодняшний форум проблема со связь	связь проблема со форум на сегодняшний актуальный	здесь сегодня <dact> проблема2 интернет связь
не столько я себя плохо чувствовать сколько хотеть оставаться дом и никто не видеть	оставаться и видеть я плохо никто не хотеть себя	1ps н-е только2 чувствовать плохо.себя.чувствовать плюс 1ps не хотеть никто видеть
если у вы появляться ещ вопрос писать мы в комментарий под видео	если у писать в видео вы если появляться вопрос под комментарий вы еще мы	или случай ещё есть вопрос писать комментарии
а за остальной деньги куда пойти	остальной пойти куда за деньги а а	а indx нужно <nums> успех <nums> еще деньги clf clf.много clf clf.деньги куда
понимать нужно делать шаг для это развитие а не то как вы требовать давать и далеко сидеть сложа рука	понимать далеко делать шаг требовать для понимать и а этот	шаг pl <dact> необходимость <dact> это развитие понимать 2ps желание требовать <dact>
отставать	отставать	отстать
ваш обычный еда не мочь так как я виноград гилберт	я я так как мочь обычный еда гилберт мой не	еда обычный простой все4 не мочь это 1ps виноград <dact>
она посмотреть вверх и увидеть красивый голубой небо и облако	облако увидеть и вверх и красивый она небо посмотреть голубой	clf clf.посмотреть clf.вверх красивый <dact> небо голубой и <dact> clf clf.облако clf.pl
из москва	из москва квартира	и-з москва
умный	умный	умный
если она не давать то она начинать гавкать	она не начинать давать то она гавкать если	если давать 3ps 1ps 3ps гавканье
и тот быть тоже быть ехать грязный рука	тоже и ехать быть быть тоже рука тот грязный	еда грязный
белый и зеленый чай зеленый кофе содержать природный кофеин который повышать влияние адреналин на жировой ткань в результат гореть наш жир	белый и повышать продукт адролин продукт белый продукт который вли	белый2 зеленый <dact> зеленый <dact> составлять природа давать <dact> это давать энергия увеличение <dact> <dact> ткань получаться poss 2ps <dact> огонь
можно еще кондиционер в вид пена он легкий сглаживать волос и придавать легкий увлажнение	увлажнение кондиционер еще он и в можно легкий вид еще прида	можно <dact> <dact> пена легко clf clf.сглаживать clf clf.волосы легко увлажнение
опыт помогать я чувствовать себя уверенный в себя	себя опыт в себя уверенный помогать чувствовать я я	indx 1ps чувствовать себя уверенный
ну да давать премия вс правильно	все давать правильно давать премия ну ну	премия 3ps давать 1ps
терпимость это то что сегодня так не хватать	так хватать сегодня что это так не терпеимость то	терпимость это сегодня нужно pl
май самый т плый весенний месяц	весенний самый плый май май месяц т самый плый	<dact> всегда теплота в.течение весна теплота
всего-навсего студент	все-навсего студент все-навсего	маловажный хз2 студент2
в полдень студент распахнуть окно и выглядывать в сад	окно полдень в сад выглядеть и студент в распахивать	день <nums> день студент2 открытый окно открытый видеть
осень ребенок надевать штаны сапог куртка и брать зонтик	осень куртка штат брать ребенок надевать и сапог куртка зон	осень дети одеться брюки сапоги куртка зонт <dact>
луиза очень привязываться к девочка но удерживать она не мочь не иметь право	удерживать не она привязываться иметь не но к луиза девочка право мо	<dact> учить сильный любить девочка н-о держать не мочь нет3 право
антон пылесосить ковер и выкидывать мусор а дедушка например помогать бабушка и заниматься внук учить антон играть в шахматы а катя читать е любимый сказка	а и играть например читать шахматы антон выкидывать	<dact> пылесосить плоский <dact> выкидывать пример дедушка 1ps помогать 3ps бабушка2 заниматься <dact> если трудно обучать2 <dact> обучать2 шахматы <dact> читать любить сказка
двигаться в правильный направление в пищевод это называться пищевой желоб	двигаться в направление в желоба пищевой пищевой это называть пищев	clf clf.двигаться направление правильный еда жевать2 внутренний <dact> назвать еда <dact>
хотеть немного подробно вы рассказывать чтобы кто-то быть полезный	рассказывать кто-то быть полезный чтобы рассказывать хорошо немного хот	немного желание подробный рассказывать открытый изучать все быть полезный
я уметь красиво писать	писать красиво я я уметь	1ps красивый написать мочь2
на поляна нет гриб	полен на нет грибной	территория гриб нет2
разрушать	разрушать	разрушение2
однако встречаться различный проблема и непонятно как двигаться далеко	далеко однако и встречаться двигаться как проблема различный непонятно	дальше тупик pl как
если сдерживаться невозможно у вы быть пара минута чтобы добегать до туалет и расслабляться	у и располагаться минута сдерживаться быть невозможно добегать	сжатый не.мочь clf clf.чуть минута.две минута.три давать что до туалет бег2 место все4
но ты спас я жизнь	спасать жизнь но я я жизнь спасать мы но	н-о 2ps спасать poss 1ps жизнь
тот же фамилия и у бабушка с дедушка ведь она переходить папа от они	же фамилия тот у они с же от переходить ведь она и бабу	одинаковый фамилия бабушка2 дедушка poss 3ps родители папа потому что папа передать 3ps передать 1ps фамилия свой родители
я тоже хотеть носить красивый платье	тоже хотеть я платье красивый носить	1ps тоже желание носить платье красивый
поэтому запасаться полезный продукт и поехать	поэтому запасаться поехать полезный продукт и	это собирать2 подготовка собирать2 и начинать
ну весь золушка теперь ты мочь ехать во дворец	во дворец теперь во ехать золушка ну весь мой мо	все сейчас <dact> 2ps мочь уезжать дворец
очень мало человек заниматься программирование	человек заниматься мало программирование очень	программирование дефицит <nums> человек все2
также плохой труба и канализация где протекать плохой вода и из кран так же бежать плохой и ржавый вода	и канализация и и кран также плохой плохой	это плохой вода труба <dact> clf clf.течь clf.из clf.крана грязный ржавчина труба pl плохой <dact>
я нравиться общаться с людьмиб интересно узнавать что случаться	общаться я с что случайться узнавать человекьмиб интересно нравиться	1ps pl нравиться общаться человек интересный узнать случай что
весь время они играть и гулять вместе как друг мальчик заболевать	время друг играть заболевать гулять и они как вместе мальчик весь	вместе pl игра гулять разнообразный вместе pl вдруг 2ps мальчик болезнь
бывать что катя и антон ссориться но потом обязательно мириться	катя мириться и антон обязательно что бывать потом смиряться	<dact> <dact> быть pl ссориться быть pl н-о потом обязанность мириться
когда человек начинать кашлять хвататься за горло что мы должный сделать как должный помогать	должный мы когда за горло как помогать начинать хвататься человек кашлять	человек начать кашлять2 задыхаться2 кашлять2 что мы должен 1ps помогать 3ps какой должен был
этот чай работать как антиоксидант бороться с некоторый процесс в организм	этот бороться работать некоторый алюминит в как организм процесс чай с	<dact> indx работать2 как <dact> как против организм что есть
он слушать когда говорить и понимать	когда слушать и понимать говорить слушать он он	3ps слушать говорить2 indx понятый
главное чтобы он действительно представлять то как бы он хотеть чтобы быть	быть быть действительно то как чтобы хотеть быть представлять он главное	главный 3ps должен представить3 <dact> 3ps желание что был
второй совсем не принимать	второй совсем не принимать переставать	следующий3 второй совсем взять не
они часто приходить на берег и плавать прыгать в вода	берег приходить они часто вода и на в пригать и плавать	двое часто приходить clf clf.берег плавание clf clf.с clf.берега clf.прыгать clf.в clf.воду
я любить красный помада	красный я любить маска	губная помада 1ps любить красный
я не хотеть выступать на концерт	хотеть выступать не на я концерт онцерт	концерт сцена принимающий участие не.хотеть
без вы у я на сердце тоска	сердце вы я у на без у точкаск вы	без 2ps сердце чувствовать грусть
желчь	желчь	<dact>
давать разбираться зачем мы есть	разбираться быть давать мы разбираться зачем давать давать	пробовать исследовать почему мы еда почему
привет друг я звать андрей	звать андрей привет я друг	привет друг pl 1ps имя а-й
каков причина этот проблема у глухой	причина у каков этот проблема глухой этот	проблема2 глухой indx причина какой
старуха удивляться	старушка удивляться	удивление старый
достоинстно	достоинственно	гордость
сейчас я заниматься инскусственный интеллект т е то как он распознавать жестовый язык и переводить он в текст такой вот у я тема	вот я и текст он я е у распознавать я так	indx тема2 какой это <dact> какой это <dact> <dact> это для2 poss 3ps <dact> говорить на жестовом языке 3ps воспринимать 1ps говорить на жестовом языке 3ps воспринимать 1ps переключаться написать использовать искусственный.интеллект внутри тема2
переходить к тема	переходить к тема	clf clf.отодвинуть тема2
счастливый	счастливый	счастливый
каков причина	причина каков	причина2 pl какой
пожалуйста научать жестовый язык	жестовый научать язык пожалуйста	пожалуйста <nums> учить3 1ps мочь2 школа пожалуйста жестовый язык
и на розовый куст на самый верхний побег начало распускаться великолепный роза	на и на вполне верхний распускаться начинать куст розовый роза	кусты розовый цветок кусты clf clf.побег clf.растения начинать clf clf.распускается clf.цветок красивый шикарный цветок
если быть учитель наставник то продвижение быстрый будет потому что ты учить и сопровождать да	быстро и учитель продвижение быть если потому и сопровождать бы	быстрый будет карьера indx опыт есть 3ps учить 1ps 1ps заместитель да
вопрос такой вы уже переболеть	переболеть вопрос вы такой уже переболеть	вопрос 3ps 1ps заболеть уже
если бы я не становиться переводчик я заниматься бы продажа быть бы экономист	быть быть я экономист если не быть заниматься быть я	если 1ps переводчик нет2 б-ы был продажа экономика2
аплодисменты	инфоэдменты	аплодисменты
бывать низко температура	температура бывать высоко	ниже быть <nums> ниже
главное смотреть на то как выглядеть волос и что вы нужно на каждый день	на выглядеть каждый вы смотреть на и главное вы нужно то как	главный вы смотреть чувствовать clf clf.волосы clf.тяжелые что вы необходимость каждый день
далеко договариваться с государство а оно просить взятка	государство договариваться взятка оно далеко просить с а а	следующий пример государство 1ps pl договор государство беседовать взятка
как пить капсула фуд контрол	как капсула пить действие фуд контроль	как таблетка <dact> <dact> как
при пережевывание еда распадаться на кусочек чтобы организм быть легко нужный слюна она смешиваться с еда и расщеплять она	еда и при на раздаваться легкий слой быть пережевывание	когда2 жевать2 еда clf clf.распадаться clf.кусок что организм легко2 нужно <dact> clf clf.смаковать еда жевать2 исчезать
весь крепко и крепко прижиматься соловей к шип и песня он звучать весь громко и громко ибо он петь о зарождение страсть в душа мужчина и девушка	и и и и душа о и весь и	птица2 clf clf.прижиматься clf.телом clf.к clf.шипу песня кричать птица2 это о-н песня о появляться эмоция все включено мужчина2 и девочка
я хотеть выступать на концерт	хотеть я выступать на концерт  концерт	1ps желание принимающий участие концерт
почему выбирать это число	выбирать почему число этот	число выбрать почему
в концертный зал кто-то быть	быть зал кто-то в концертный	концерт зал <dact> кто есть indx
лето расти вкусный яблоко	лето расти яблоко хорошо вкусный	лето расти вкусный яблоко clf clf.есть clf.яблоки
вот значит ствол дерево это возникать проблема нужно узнавать каков е причина и какой оказываться последствие	возникать и дерево вот е возникать какой е послед	indx indx дерево clf clf.ствол clf.дерева indx проблема2 indx причина <nums> что какой pl indx результат итог
они предлагать такой рабочий место куда человек с инвалидность не мочь устраиваться	устраиваться рабочий предлагать мочь не место такой куда инвалидность они	3ps предлагать такой работа место куда инвалид вступить просто не.мочь
они уничтожать танк противник с то чтобы обеспечивать дальнейший продвижение пехота	уничтожать они пехота дальнейший обеспечивать чтобы противник танк то	танк уничтовать что clf clf.люди двигаться
мой мама ой мой папа закаляться не знать каждый день чтобы не заболевать обливаться хлодный вода ну знать стоять под холодный душ	душа каждый день под знать вода не ходный заболевать анна обливаться	poss1 мама poss1 папа <dact> не знать каждый день что болезнь нет clf clf.обиваться холодно не знать душ
пока	пока	прощаться
трудный	трудный	трудный
я часто слушать история на ваш канал и теперь решать поделиться свой	история теперь ваш я решать канал слушать на и часто по	часто слушать история poss 2ps программа и решать разделение 1ps делиться 3ps собственный
в итог никакой поступление энергия нет	поступление энергия нет никакой итог в итог	и ждать2 электричество тратить успех тоже нет2 запас
рубль нет даайт посмотреть что туда входить	рубль нет туда что входить даайт посмотреть туда входить	<nums> рубль не <nums> рубль нейтр.имп смотреть входить.во.что-то что
я тоже понимать что уже не мочь без он	понимать без уже он тоже я что не мой мочь тоже	1ps сам2 думать что без 3ps 1ps не мочь
поэтому она открывать страница в Instagram о рыжий кот где рассказывать история о бобо который недавно выходить на пенсия	история рыжий который поэтому о она на страница рассказывать где откры	поэтому рыжий кошка3 <dact> открывать instagram2 страница рассказывать история <dact> 3ps совсем недавно уже выходить пенсия
если не получаться то во время реанимация инородный тело оно пройти в один из бронх и тогда один из легкий смочь дышать дыхание будет частичный не в полный объем	дыхание и тело в полный реанимация проходить если один смо	если получаться нет т-о в-о время реанимация может.быть поперхнуться бронхи <dact> clf clf.инородное clf.тело clf.сдвинуться удача <nums> легкое удача пустой будет дышать н-е полный н-о часть будет
крепко прижиматься ко я милый соловушка не то день прийти рано чем заалеть роза	приходить крепко прижиматься не приходить я милый рано роза день	clf clf.тело дорогой птица2 если день начинать заранее красный изменять не.успевать
он не уметь кататься на лыжа	лыжа не он уметь кататься на терпеться	о-н мальчик 3ps не мочь не знать кататься.на.лыжах
и вот мы сыграть свадьба и я переезжать к он у они быть три комната в квартира	и они и квартира я и сыграть к у вот	вместе свадьба 1ps переезд у 3ps indx все включено квартира у 3ps был <nums> комната pl clf clf.комнаты
мочь быть будет кто-то с кохлеарный имлант	кохлеарный имлант быть мочь с быть кто-то	может быть кто есть к-и кохлеарный.имплант
обязательно быть ошибка а расчет примерный	обязательно быть расчет ошибка примерный а а	должен ошибка pl clf clf.уровень clf.разный примерно сравнить пример рассказывать
раздражать этот бесконечный ветер	бесконечный ветер этот раздражать	раздражать всегда ветер раздражать
чтобы не заболевать я делать зарядка	заболевать делать чтобы я не зарядка я	что болезнь нет 1ps делать зарядка2
кролик обращаться а я рано не быть настоящий	обращаться я рано настоящий а быть не я кролик	кролик обратиться indx раньше2 не.был настоящий не.был
лето можно играть в песочница лепить кулич из песок	играть песокица играть можно в из лето кулич песочный песок	лето мочь игра песок делать пирожок pl делать песок
я самый трусливый и самый слабый из весь животное	самый я и самый слабый животное трусливый самый в	1ps самый3 трус и самый3 слабый2 и-з животное pl
главный задача угвеод обеспечивать мы быстрый энергия во-первых белок и жир организм усваивать в определенный количество а угвеода приниматься в любой количество	приниматься удваивать и в белый в удваивать количество энергия	<dact> это 3ps давать 1ps быстрый электричество почему пример <dact> <dact> это внутри.себя воспринимать точно сколько 1ps нужно лишний не.нужно воспринимать а <dact> все любой получать pl воспринимать
он ездить на автобус	он автобус на ездить	о-н ехать.на.транспорте автобус автобус
если у вы волос торчать то и вы хотеть они сглаживать то нужно использовать коллаген шелк кератин и белок	и и они у если и шелк вы хотеть то	если у 2ps pl волосы clf clf.волосы clf.торчат clf clf.волосы clf.торчат желание clf clf.сглаживать что что необходимость использовать <dact> <dact> <dact> <dact>
живот сообщать мозг и он понимать ой да да да где здесь туалет	да понимать здесь да и да где он ой да животное да ту	живот indx сообщение 1ps мозг возникать понимать да pl тулет искать
тема будет очень интересный о переводчик какой он должный быть какой качество должный обладать и т д	качество должный обладать какой очень быть о какой и	тема2 интересный о человек2 переводчик какой должен был какой качественный какой правила2 что пример список2 исследовать будет
потому что когда вы начинать делать что-то в ущерб себя вы начинать ненавидеть тот для кто это делать	когда-то это для ущерб себя начинать делать кто	например 1ps себе заставлять3 pl похоже 1ps начинать человек pl ненавидеть2
он встряхиваться отчего мышонок упасть на земля	отчего упасть он земля встряхиваться мышонка на	трястись2 мышь2 падать2 н-а земля
и давать направление действительно нужно развивать	действительно направление развивать давать нужно и развивать	и это направление действительно нужно развивать
я премия не давать	премия давать не я я	премия давать 1ps не был
чуть в легкий не попадать	в попадать легкое чуть не	indx clf clf.чуть легкие попал clf clf.чуть
вот например весь знать проблема глухой работа и т д	работа глухой вот т и например знать дмитрий весь проблема	1ps пример проблема2 глухой все самый знать проблема2 работать перечислять2
нужно делать шаг	нужно шаг делать делать	необходимость шаг pl
сжимание стенка называться перистальтика	перистальтика стена сжимание называться	clf clf.стенки clf.пищевода clf.сжиматься назвать <dact>
а человек заложник потом отпускать	потом а отпускать заложник человек а	брать.за.руку уводить да
сразу невозможно быть получать	получать быть невозможно сразу	indx <nums> любой толпа получать не.мочь.сделать
в трудовой ресурс зарплата такой же как в материальный	материальный же такой как в трудовой зарплата ресурс в штраф	зарплата труд тоже indx мочь ждать
мой брат не любить шоколад с то момент как отравляться он	отравляться не мой как тот момент любить он с мой отравляться как то брат	когда2 3ps poss <nums> брат яд шоколад после2 это не.любить шоколад
я весь этот три день участвовать рассказывать защищать свой проект сказать что у я уже быть письмо поддержка например от музей балл быстро подсчитывать и это быть успех	и быть успех я защищать я и этот я	день <nums> это indx 1ps делать 1ps рассказывать 2ps защищать 3ps финал защищать 1ps рассказывать 2ps что 1ps indx <dact> есть 3ps поддерживать 1ps печать indx спонсор все есть известный быстрый <dact> и 1ps успех
смотреть группа из человек это мало человек это много	много человек это смотреть человек много это из группа	смотреть indx <nums> человек группа <nums> человек мало <nums> человек множество толпа
урок называться наш дружный семья	дружный называться наш урок семья	урок назвать poss 1ps pl дружба семья
кто там в новосибирск быть	быть там новосибирск кто там в	кто indx indx новосибирск есть
а проблема то в то что мы мочь говорить на жестовый один рука а в англия человек так не мочь	говорить рука то говорить а не в а один жестовый то в англи	indx проблема2 indx англия жест только2 fs clf clf.использовать clf.обе clf.руки два говорить на жестовом языке рука один говорить на жестовом языке мочь2 телефон говорить на жестовом языке мочь2 англия нет3
ну если ничто нет давать варить каша из топор	если каша ничто давать ну нет варить топор из если	н-у если ничего нет2 нейтр.имп. пробовать готовить <dact> и-з топор2
первый раз укусить начинать жевать	раз начинать жевать первый усить	когда2 первый clf clf.укусить начать жевать2
температура то повышаться то понижаться снег мочь то неделя лежать а мочь мало и потом растаивать	то температура лежать потом снег то повышаться и растаивать неделя	температура повышать быть понижать clf clf.толстый clf.слой <dact> <nums> неделя мочь меньше таять
главный дед мороз удивленно посмотреть на он и сказать теперь ты быть не маленький дед мороз а лесной	и теперь маленький а на он быть посмотреть а глав	дед.мороз видеть главный видеть удивление дать был <dact> дед.мороз поменять <dact> что лес точно
медвежонок ларсить жить на северный полюс вместе с мама и папа	медвежонок и ларшать жить с вместе северный на папа	медведь имя <dact> жизнь место clf clf.шар indx северный вместе родители
в это дом не бывать гость	гость этот не дом в бывать	это дом гость ноль
ошибка считать что можно похудеть быть принимать капсула лежать на диван и ходить по тысяча шаг в день каждый день увеличивать это количество на шаг	лежать можно и принимать на лежать капсула день	все думать лекарство лежать лекарство уже <nums> тысяч <dact> ходить нужно каждый день увеличивать <nums> ходить увеличивать
пожалуйста выбирать то кто по ваш мнение входить в сообщество глухой	выбирать сообщество входить ваш по глухой в мнение то кто пожалуйста	пожалуйста выбрать pl поставить.галочку выбрать poss 2ps мнение что включать мир2 глухой
весь спрашивать почему на юг так популярный одежда защищать от ветер	ветер юг одежда от популярный защищать спрашивать так почему на весь	все спрашивать 1ps ю-г популярный clf clf.толстая clf.одежда защита ветер
я в близкий время хотеть сделать опрос о то кто желать становиться глухой экскурсовод экскурсовод для глухой	хотеть я для глухой время опрос кто о сделать близкий	1ps будет опрос 3ps pl кто желание переводчик глухой <dact> проводить кто желание есть желание
проходить день неделя а она весь мечтать	она день весь проходить неделя а а лететь прекрасный	желание проходить день проходить неделя
ясный	ясный	яркий солнце светлый
да он мастер форма это у он отнимать нельзя но быть ли у он чувство	у чувство у отнимать быть он у форма но он нельзя это мастер	да 3ps мастер песня голос2 качественный н-о интересный у 3ps чувствовать общий есть нет2
у они бюджет быть от сто двести тысяча и высоко	от тысяча и быть от они бюджет высоко они сто двести у	3ps финансирование2 о-т <nums> тысяча pl и выше
в инкубатор быть свой плюс ты давать помещение оказывать финансовый и юридический помощь оборудование техника много что давать	финансовый и юридический оказывать техника и давать плюс бы	это <dact> попадать indx <dact> плюс pl что 3ps давать 2ps комната2 мочь 3ps давать 2ps бухгалтерия юрист помощь множественный что 1ps давать 2ps мочь механизм компьютер
ладно сам доносить	сам доносить правда только	пусть сам2 clf clf.нести clf.на clf.плече
маша не спать весь ночь она готовиться к экзамен	экзамен готовиться весь к ночь маша не она спать	<dact> н-е спать не все нет с утра до вечера ночь 3ps подготовка экзамен
в магазин быть сыр	магазин в быть сырой	магазин <dact> магазин есть
очень много глухой готовый заниматься л гкие дело	очень л много готовый гкий дело заниматься глухой очень	человек много человек pl так будет делать хуже дело
но с ветер конечно по-другому	по-другому но ветер с конечно но	ветер случай другой будет
гаснуть	гаснуть	clf clf.свет clf.выключить
энергия давать позитивный мышление и жизненный тонус	энергия позитивный жизненный давать мышление тонус и позитивный	энергия давать 1ps мысль плюс pl и жизнь возбуждение
но это мой жизнь	жизнь но мой это	это 1ps жизнь
если я король то ты очень храбрый принц это лес	очень я если король этот я лесной принц это то храбры	если 1ps король т-о 2ps очень смелый <dact> лес2
эхо понести этот трель к свой багряный пещера в гора и разбудить спать там пастух	гора и там свой платух в понести там пещера срывать к	приветствовать clf clf.эхо clf.распространяется гора clf clf.эхо clf.распространяется звук clf clf.эхо clf.распространяется кто пастух indx спать слышать просыпаться
в результат слышать ребенок не давать жестовый язык	жестовый ребенок давать не результат слышать язык в переставать	какой это н-е давать нет слышащий дети2 жестовый.язык
как это из топор можно сваривать каша	как топор сваривать каша это можно из топор	как <dact> и-з топор2 мочь готовить вопрос
животное встречаться влюбляться с первый взгляд подружиться и помогать друг друг выздоравливать	встречаться друг друг помогать выдоравливать и взгляд животное первый с	такой встреча <nums> 3ps 3ps животное2 <dact> влюбиться первый взгляд.друг.на.друга дружба друг.друга помогать 3ps 1ps pl здоровый
быть тот кто смотреть и говорить ну это же так просто и легко не смотреть	просто смотреть кто и говорить легко и смотреть ну просто быть	мочь кто смотреть н-у простой легко2 все4 поэтому кто смотреть не.нужно
нечестный	нечестный	честный нет
рано он называться иср а сейчас название новый истый	новый рано а называться иср название он а сейчас истый	раньше был <dact> сейчас3 новый <dact>
фрукт уже практически нет	нет уже практически фрукт фрукт	плод pl мало уже
весь ребенок начинать изучать жестовый язык	жестовый начинать изучать язык ребенок весь	ребенок уже начать задавать.вопросы жестовый язык
вдалеке увидеть деревня	увидеть деревня вдалеке	смотреть деревня далеко3
сам смотреть что вы надо что не надо	сам не надо что что смотреть вы надо надо что	сам2 смотреть как нужно что poss 2ps pl что не.нужно
и он высовываться из окно и сорвать она	он сорвать и и окно высасываться она из и	студент2 clf clf.высовывать clf.голову clf.из clf.окна окно clf clf.высовываться clf.из clf.окна срывать clf clf.держать clf.цветок clf.в clf.руке
она быть такой же злой и вредный	злой такой вредный она же быть и	характер такой.же злость вред
вы так беседовать со свой ребенок	со свой ребенок так беседовать вы маленькок вы со так	тоже 2ps pl беседовать собственность дети2
делать нужно в определенный модификация	модификация нужно определенный делать в	н-о только2 делать в странный мода
следующий человек потерять слух во взрослый возраст	во следующий возраст человек потерять слух взрослый	следующий2 человек pl кто оглохнуть взрослый
например первый это грант	первый это грант например бастрахов это	пример первый <dact>
мальчик ловить и крупный рыба	рыба ловить крупный мальчик и	мальчик ловить великий рыба2
первый это хлопок по спина	первый это похлопок спина	первый 1ps нужно спина clf clf.человек clf.выбить clf.инородное clf.тело
как сделать я	как я сделать я сделать	как делать 1ps
работа в команда похожий на профессиональный спорт	профессиональный похожий команда на спорт работа в	indx и почему 1ps говорить объяснять команда indx такой профессионал спорт
здравствовать	здравствовать	здравствуйте
на этот земля не расти ни кукуруза ни картошка	кукуруза расти не ни ни этот на земля картошка ни	земля территория расти <dact> картофель расти не мочь
что мы нужно сделать	нужно мы что сделать сделать что	что мы нужно делать
я быть делиться свой опыт	быть свой опыт делиться я я	1ps свой опыт будет 1ps делить советовать рассказ кто 3ps pl жестовый.язык
друг	другой	друг
а у старушка весь быть	старушка у быть весь а а	3ps у 3ps старый все есть
наслаждение	награждение	наслаждаться
я любить сосиска	любить я сосизск	1ps сосиски 1ps любить
ветер здесь до м с	до здесь ветер м с до м	ветер до <nums> м секунда
нужно изменять себя внутри переставать заставлять себя и жертвовать себя	себя и заставлять себя изменять переставать себя внутри жертвовать нужн	нужно внутри.себя изменять себе заставлять3 нет2 отдавать.себя нет2
необходимо привозить оборудование который предоставлять электричество	привозить необходимо оборудование который предоставлять электричество необходимо	необходимость собственность clf clf.взять clf.привезти оборудование электричество деньги clf clf.взять clf.привезти необходимость доставка
ругать	ругать	ругать2
падать снег и быть темно	падать снег быть темно снег и	идет снег был ночь
грубый	грубый	грубый
слышать всегда смотреть на то какой вы команда если сильный вы быть работать	всегда слышать работать смотреть если на какой команда то быть вы	слышащий 3ps pl видеть команда какой 3ps команда сильный будет делать
получаться столбец не связанный слабо связанный средне связанный сильно связанный	связывать связывать связывать связывать связывать связывать связывать связывать столбец	получать2 clf 4.столбца первый здесь связать пустой так.себе связать норма нет2 столбец связать есть н-о так.себе слабый связать есть средний связать крепкий
попадать	попадать	попасть clf clf.что
я начинать этот занимать в год и обучение там длиться день с утро до самый вечер	занимать обучение утро я с длиться вечер самый занимать и это	1ps начинать был <nums> indx день <nums> учиться с утра до вечера учиться
и он вернуться к себя в комната вытаскивать большой запылить книга и приниматься она читать	и большой вернуться вытаскивать книга и приниматься к	студент2 обратимый домой комната собственный книга clf clf.книга clf.большая clf.тяжелая протирать <dact> протирать и clf clf.открыть clf.книгу начинать взглянуть читать
отношение быть меняться	отношение меняться быть быть	отношения изменять будет
можно ли в ваш регион подписывать соглашен о трудоустройство человек с инвалидность в другой организация	организация регион подписывать можно в другой соглашать о трудоустройство в инвалид	можно л-и poss 2ps регион подпись <dact> о трудоустройство инвалид другой организация
он никогда не быть в турция	турция быть не он в никогда	3ps никогда2 турция не был
или если у вы быть знакомый который знать финский жестовый язык передавать он этот информация пожалуйста	знать или у если знать который он этот быть пожалуйста язык информация	или у есть знакомый 3ps знать жестовый.язык2 финляндия 2ps передавать пост2 видеть отправлять пожалуйста
подымать	подымать	clf clf.поднимать
я видеть что вокруг много молодой человек школьник который не думать куда поступать а думать куда пойти они друг или куда направлять они родитель	куда куда школьник куда они видеть куда друг молодой	так 1ps замечать вокруг много молодой и школа думать 1ps куда поступать брать.пример.с друг родители 3ps заставлять2 1ps
у третьяков быть хобби он быть меценат и оплачивать строительство школа для глухой ребенок выделять целый тысяча на это и в год построить трехэтажный здание школа	тысяча год и быть на и триэтажный для построить хо	и <dact> 3ps <nums> дело хобби 3ps деньги финансирование забота семья школа для глухой <nums> тысяч отправить з-а строить clf clf.здание строить <nums> год этаж <nums> здание
тамара долго идти по почти непролазный дорога и вдруг увидеть дым из труба один из дом она обрадоваться побежать подавать и весь грязный добираться наконец до это дом	и и дым пойти она тамара вдруг почти из грязный	ходить медленно место дорога был неприятный стремный н-о глаз indx дом дым и видеть бежать2 падать2 плакать тело грязь добраться до это indx дом
мы радоваться когда гладить котенок и чужой слово влиять на наш настроение	когда наш влиять наш настроение радоваться наш и на котенок чужой слово	когда2 мы радоваться радоваться что видеть например кот indx что гладить2 слово чужой сказать 1ps влиять 1ps настроение
хм а кто же будет кучер	же быть кто хм а а космонавт хм	задуматься кто 3ps будет кучер
там быть мой кворки нажимать создавать кворк	создавать быть там нажимать кворк кворка мой кворка	indx <dact> <dact> indx строка создать <dact>
смотреть как он обучать что нужно добавлять	добавлять нужно обучать что смотреть добавлять как он	<dact> clf clf.человек обучать2 что необходимость добавить
мой отец бояться мачеха	отец мой бояться отец бояться майматчеха	poss 1ps папа мама второй бояться3 бояться
к сожаление фотография прабабушка и прадедушка родитель бабушка и дедушка не сохраняться поэтому на это дерево весь начинаться с бабушка и дедушка	и и дерево и сожаление фотография на и бабушка дед	сожаление фотокамера <dact> дедушка <dact> бабушка2 отсутствие 3ps родители 3ps бабушка2 дедушка отсутствие сохранять отсутствие поэтому indx дерево все начать бабушка2 и дедушка
ну в общий это вс что я хотеть сказать	все я хотеть общий что это сказать в ну	все результат 1ps желание сказать
это желание будет помогать копить	помогать копить этот быть желание	это желание 1ps помогать 1ps копить будет
ленивый	ленивый	ленивый2
муравьед любить кушать насекомое авокадо цитрусовый	муравьед любить авокадо сикомое муравьед курать	3ps еда <dact>- паук <dact> апельсин <dact> еда обожать2
зато рейтинг высокий и много заказ а у он все заказ быть отзыв	высокий у много заказ быть он и рейтинг заказ заказ у весь а	3ps высший р-е- заказ pl много у 3ps <nums> 3ps заказ быть pl <dact>
когда у маленький дед мороз весь подарок быть готовый остальной вс думать что снова надо будет ехать дарить ребенок подарок возвращаться домой что это очень скучно	когда очень готовый у ехать все у возвращаться очень быть	3ps подарок похоже готово clf clf.коробки clf.расставить готово это ждать все дед.мороз неинтересно опять2 не.хотеть ехать.поездом дети подарок pl назад домой не.хотеть похоже неинтересно поэтому думать обсудить пусть
еще раз хотеть сказать что каждый момент свой жизнь нужно наполнять радость	хотеть каждый момент свой раз еще хотеть жизнь наполнять что радость	еще раз хотеть сказать каждый момент свой жизнь нужно наполнять радость
костик и мишка сказать тоже где ты быть что с ты приключаться рассказывать	что быть где сказать рассказывать и тоже с костика мишка	еще <dact> <dact> 3ps спрашивать 1ps тоже где был случай что 2ps рассказывать 1ps
семен по путь с работа забирать дочка из садик и к ужин они всегда быть дом но не в этот злосчастный день	и день они дом ужин злосчастный быть забирать по этот все	<dact> работать clf clf.человек clf.идет 1ps забирать 3ps дочь и-з дети <dact> и вечер всегда2 домой еда стол н-о попадать день беда
и по свисток начинать собирать человек на съезд в москва начинаться беготня в общий постанавливать собирать человек в москва в июль год	начинать в июль в москва общий в начинать человек постанавливать	и свистеть начинать clf clf.люди clf.собираются clf.в clf.одном clf.месте съезд москва попал беготня общий постановить clf clf.люди clf.приходят москва <dact> <nums> год2 <dact> clf clf.люди clf.приходят
как жираф	как тяжелый	жираф похоже
смотреть результат быть	результат быть смотреть может	смотреть иметь результат
краудфандинг	крайудрангинг	<dact>
когда вы себя насиловать унижать у вы нет уважение к себя вы не в состояние что-то давать	вы себя у когда-то вы вы в вы себя вы что-то насил	похоже отдавать.себя себе унижение себе уважать 1ps нет2 похоже 1ps не мочь давать pl
однажды они зайти в лесной глушь	зайти в глушь они лесной одиножды	вдруг лес внутри
мама он сразу начало учить я жизнь что я должный муж беспрекословно во весь слушаться и сразу выполнять весь что он требовать	я сразу весь во я сразу и слушаться я должный	мама poss 3ps начинать 3ps учить2 1ps <dact> жизнь что 1ps муж должен был послушный2 3ps заказывать 1ps 3ps приказать 1ps 3ps требовать 1ps 1ps выполнить
я работать уже давно с начало создание адаптиса	создание давно уже работать я адаптус начинать с уже	1ps стаж2 давно все4 работать2 когда начинать создавать2 sn
без знание жестовый язык этот ребенок не являться CODA	жестовый CON без язык ребенок являться не этот знание	жестовый.язык не.знать считать2 н-е кода нет 3ps
нордис в г новосибирск	новосибирск в г норди	<dact> новосибирск здесь
благодаря плодоножка вишня в организм не накапливаться лишний жидкость а в жировой ткань активизироваться процесс микроциркуляция	жидкость микроциркация в лишний а в процесс активизировать не нака	еще clf clf.плодоножка indx indx н-е 3ps давать 1ps добавлять жидкий лишний внутри.себя и активный промежуток.времени управлять <dact> внутри.себя ткань
они поехать в приют и предлагать вместе с они собака пойти на долгий прогулка	они предлагать прогулка они долгий приют собака вместе с по	<dact> поехать место <dact> и нейтр.имп вместе собака poss 3ps забирать и гулять долго
я вс учитывать и тогда я получать удовольствие от работа потому что она быть в кайф	я от я в удовольствие работа я быть весь и то	1ps все считать2 и 3ps pl удовольствие 1ps работать почему indx кайф3
вообще весь человек журналист ленивый	вообще человек весь журналист ленивый совершенно	все журналист все человек pl ленивый все
я удаваться оформлять кредит благодаря то что в банк к мой проблема относиться с понимание	кредит я банк оформлять благодаря что к проблема удаваться понимание в относиться	1ps мочь2 оформлять кредит почему благодаря понимать 1ps есть проблема2
готовый	готовый	готовый
потом няня становиться жалко кролик но доктор сказать надо сжигать и давать новый	потом новый и няня давать жалко но новый становиться надо	потом 2ps няня2 смотреть жаль врач2 спрашивать доктор2 indx кролик indx так огонь новый давать
но вы сам понимать что связь у я не так много но то не менее шанс уже быть у вы быть шанс получать помощь	шанс но быть уже знать вы вы шанс но связь вы получать	н-о у 1ps понимать2 зависеть мало временный есть 2ps pl <dact> есть радость 2ps спрашивать 1ps
и плюс всегда развиваться учиться идти вперед	развиваться всегда и плюс идти вперед учиться и	и плюс всегда развитие учиться идти.вперед
и если милиция я не находить	милиция и если я не находить я	вдруг indx милиция 1ps 1ps искать 3ps успех нет
спонсор готовый платить я выполнять проект в это город нехватать мыло я сообщать спонсор получать мыло и раздавать	получать я нехватить платить и этот город мыло выполнять спо	платить2 согласие постоянный платить2 1ps проект выполнять сдать pl город indx не.хватать 1ps объявлять 3ps clf clf.взять clf.мыло сдать pl
сейчас глухой начинать активно заниматься индивидуальный предпринимательство и это плюс потому что они становиться независимый	начинать активно и глухой становиться независимый индивидуальный предпринимательство плюс	все и-п мочь indx плюс потому что свой зависимость не
они наблюдать и чувствовать что необходимо создавать общество для ребенок CODA	наблюдать и они общество COD ребенок создавать необходимо что чувствовать	смотреть pl чувствовать что нужно создавать2 общество группа для кода
либо где можно находить спонсор чтобы получаться сокращать количество деньги и расход быть по ноль	где можно и деньги быть либо расход сокращать по где	или где можно находить спонсор что составлять получаться деньги кратко расходы ничего
кто-то печ т торт кто-то фотографировать работать в такси и развивать автопарк кто-то заниматься ремонт	кто-то кто-то кто-то ремонт и т кто	кто торт печь кто фотография2 достигать кто такси подготовка автомобиль <dact> развитие кто ремонт
я очень рад что быть выбор профессия специальность	быть очень что я специальность рад профессия выборы	1ps очень радостный есть выбор профессия специальность
она помогать она заниматься научать готовить печь шить они часто вместе гулять ходить в музей и на выставка	она они и часто готовить она ходить научать вместе на шить	помощь учиться 1ps учить2 3ps готовить пирожки пирог шить вместе часто прогулка музей выставка смотреть2
также от до процент калорийность идти на пищеварение	пищеварение также процент до протеинйность на до идти однако	еще о-т <nums> до <nums> процент <dact> мы тратить н-а пищеварение
многий из они еще и работать переводчик в вуз	переводчик работать вуз еще они и в многий из еще	и 3ps pl переводчик много посетить <dact> переводить работать посещать.и.то.и.это
встреча	встреча	встретить
я говорить что нужно сюда а он в другой место доставлять	другой доставлять я сюда нужно что а место в говорить он	1ps не 1ps indx доставка 3ps 1ps 3ps не indx
гость ничто не купить к чай	гость ничто не купить чайка к купить	гость pl ничего3 деньги не <dact> чай indx
это он собака	собака это он	это poss 3ps собака
да да постоянно калька	да да постоянно калька да кобка да	да да калька2 pl
я состоять в ассоциация слышать гид	гид слышать ассоциация состоять я в я	1ps есть включать содружество <dact> проводить <dact> слышащий включать
дом красиво украшаться весь делать друг друг подарок вместе играть и танцевать	друг играть друг вместе делать друг подарок и играть весь дом укра	дом красивый украшать все делать подарок подарок2 все семья игра танцевать
мы отда м себя полностью и жд м любовь к себя	любовь отдавать себя полностью к себя и м м м	отдавать.себя pl ждать2 любить себе
важный использовать бальзам если волос повреждать и торчать	повреждать и использовать если гельзам и торчать волос важный	бывает clf clf.волосы clf.торчат получаться clf clf.волосы clf.повреждены волосы clf clf.волосы clf.повреждены получается clf clf.волосы clf.повреждены сломанный clf clf.волосы clf.торчат получаться
не ловко ну да ладно	да ловко ну не правда да ну	неудобно2 ладно
как это на жестовый передавать	передавать жестовый как на это	жест как передавать
солдат посолить и снова попробовать	солдат попробовать снова и поливать	солдат немного солить новый пробовать
ведь это самый настоящий кошмар	самый ведь это настоящий кошмар пекмар	страшный будет
допускать к вы приш л пациент со свой проблема и вы выяснять что у он быть психосоматический влияние	выяснять он и быть к вы приходиться вы что у вы л вли	случай пример человек clf clf.человек clf.приближается у 3ps есть проблема2 3ps видеть что у 3ps есть мозг <dact>
выделять деньги на школа	выделять на школа деньги переставать	школа clf clf.выделять clf.деньги
когда вы чувствовать себя хорошо и человек вокруг вы чувствовать себя хорошо уровень жизнь качественно поменяться	себя человек когда качественно жизнь хорошо поменяться чувствовать и	1ps хорошо 1ps делать для 3ps pl <dact> себе приятный все себе чувствовать хорошо жизнь уровень изменять
давать поговорить по душа	поговорить давать по душа переставать	нейтр.имп. общаться душа
у он быть одежда	быть у он одежда	одежда2 нет одежда2 у 3ps есть
на следующий день они вдвоем встречаться с орел	они следующий день встречаться вдваивать орел на с треть	следующий день двое встреча орел встреча
я из семья глухой мой мама и папа глухой	я мой и мама из семья глухой глухой я мама глухой	1ps семья глухой poss 1ps мама папа глухой
спрашивать у лощадь как быть всегда вместе с мальчик	у вместе спрашивать быть всегда как  площадь мальчик с площадь у	обратиться мальчик вместе indx нет
когда быть просить мало деньги то и грант вы легко давать	легко мало когда грант и деньги то давать просить быть вы	<dact> деньги мало просить деньги мало грант легко
находить	находить находить	находить
састье слышать	састье слышать слышать	счастье слышать
говорить	говорить	говорить
вога кормить себя плюс еще инвалид кормить	себя кормить еще инвалид плюс кормить и вога	indx <dact> себя 1ps кормить 1ps плюс еще инвалид кормить 3ps
когда знать что быть резерв на душа спокойно а когда потратиться переживать лишний раз вдруг увольнять	переживать когда спокойно когда душа когда раз лишний знать у	знать копить indx 1ps на.душе.спокойно 1ps выбросить переживать вдруг уволить думать лишний
я всерьез это никогда не воспринимать но когда увидеть он возмужать взрослый почувствовать как защемлять сердце	когда я воспринимать но сердце никогда почувствовать защемлять	1ps <dact> серьезно воспринимать нет и видеть сегодня2 взрослый 1ps нравиться
мужчина схватывать чемодан в один рука сумка в другой и на ход потому что поезд уже начинать медленно ехать вскакивать на ступенька	нога двигать в и двигать на уже что другой двигаться в мед	мужчина2 взять <dact> clf clf.сумка clf.взять сумка clf clf.бежать что поезд начать clf поезд ехать и clf clf.человек clf.прыгнуть ступенька
деньги я не давать но выписывать рекомендательный письмо письмо поддержка начальство поставлять печать	поддержка письмо я выписывать но печать письмо не деньги поставлять	1ps согласиться письмо поддерживать согласиться заполнять администратор печать качественный clf clf.держать clf.письмо clf.в clf.руке хорошо
в конец июнь начало июль уже созревать вишня черешня абрикос	конец уже июль июнь абрикос кончать в созрева	clf clf.плод clf.pl готовый последний3 июнь начинать июль indx вишня <dact> <dact>
сахар в кровь расти а вслед за этот расти и количество инсулин	расти а кровь инсулин количество сахар этот вслед расти	сахар в красный увеличивать множественный и плюс множественный <dact> добавлять pl
не то чтобы он не хотеть я слушать но просто он вс это быть безразлично	быть слушать просто не но не он все чтобы он это хотеть безразлично	мальчик н-е только не хотеть 1ps слушать тоже 3ps безразличие
он думать лишь о музыка а всякий знать что искусство эгоистично	о знать музыка всякий а эгоистичный думать искусство	3ps думать только2 о музыка все знать искусство indx только2 думать о себя pl
а ефросинья петровна надо я видно просыпаться от это грохот	а от надо это видно я ефросинье просыпаться а	<dact> <dact> открыть.глаза
можно делать сковоречник	можно делать горячий заморозок	мочь делать дом для птица
когда реб нок чувствовать что он не один он начинать по-другому относиться к свой родитель открываться он	когда он он родитель к начинать открываться не относиться он по-друг	1ps <nums> нет 1ps чувствовать открытый и начать относиться папа п-о другой
очень довольный	очень довольный хорошо	очень довольно
за этот три год в инкубатор вы расти и становиться сильный но кроме этот пункт который я уже объяснять быть и другой способ получать деньги на свой проект	и и уже и и я быть на и и	год <nums> выпускать2 <dact> родиться больше уже сильный выпускать2 это множественный мочь другой талантливый 2ps проект есть все включено делать карьера
я звать елена	звать елена я	здравствуйте 1ps имя <dact>
утом помогать запускать обмен вещество на максимальный скорость работа щитовидный железа давать прилив энергия и хороший настроение а вечер наоборот успокаивать настраивать на хороший сон и защищать от обжорство и ускорять расход жир из наш запас	запас энергия и и вечер и щитовидный а наоборот	утро помогать 1ps clf clf.организм clf.процесс clf.начать максимум скорость clf clf.организм clf.процесс clf.работать работать2 щитовидная.железа ш clf clf.щитовидная clf clf.организм clf.процесс энергия clf clf.организм clf.процесс и настроение хорошо а вечер2 наоборот успокоить слабость спать хорошо защищать о-т еда pl нервный отсутствие <dact> тратить запас быстрый
ну вот же у ты готовый ответ	же готовый у вот ну вот ответ же у ты	готовый ответ
я заканчивать учиться пойти работать туда где быть глухой	где туда работать я заканчивать пойти быть глухой я у	1ps учиться конец поступать2 работать2 место глухой
вот	вот	здесь
потом я подзывать свой ребенок который знать жестовый язык он весело подходить ко я	подзывать который он подходить подзывать жестовый знать потом он ребенок весел	потом ребенок poss 1ps ребенок нейтр.имп ребенок оживленный нейтр.имп 1ps жестовый язык знать clf clf.подойти нейтр.имп
начинать дуть ветер	дуть начинать ветер	ветер pl начинать
в холодильник нет еда	нет в еда в холодильник	холодно indx еда нет2 ноль скелет2
что же делать	же что делать делать же	что делать
ты бояться даже ветер	даже ветер бояться бояться мы	2ps бояться даже ветер
в понедельник мы быть проводить прямой эфир	понедельник быть проводить эфир прямой в мы	у 1ps будет понедельник завтра будет проводить п-э
Ещ дедушка с антон хотеть сделать семейный древо	семейный дедушка антон хотеть щь сделать с семейный	еще дедушка вместе <dact> желание делать дерево ветвь pl семья
семья это сложный но жить один невозможно	семья сложный невозможно один но жить это	семья это сложный н-о счастье жить <nums> невозможный
конечно нужно чтобы кто-то вызывать скорый помощь	скорый конечно чтобы помощь кто-то вызывать нужно	конечно нужно чтобы кто заметить indx вызвать <nums>
тома находить в себя сила прощать муж хоть и даваться она это нелегко	муж нелегко прощать даваться сила и хотеть находить себя в	<dact> успех себя сильный прощать2 мальчик муж действительно был тяжелый
работник китайский магазин в нью-йорк взять он в магазин и он оставаться там на год	год нью-йорк взять оставаться китайский он работник в в	магазин нью-йорк китай магазин взять и оставить <nums> время
вечерний капсула пролонгировать лимфодренажный эффект получать на первый шаг	пролонгировать первый получать шаг на эффект вечерний капсула лимфодрожный	вечер капсула indx <dact> жидкий 1 <dact> был 3ps давать 1ps indx управлять clf clf.выравнивать
да вредить	вредить да	наносить.вред
борис джонсон болеть в март	март джонсон болеть борис в борт	3ps <dact> <dact> заболеть был <dact>
сестра пойти на бал а я нет	я пойти бал на сестра нет а а	сестра двое уезжать бал 1ps не будет
в мой город нет аэропорт	нет в аэропорт мой город	poss 1ps город аэропорт нет2
мочь быть я смочь взламывать сенсор ааа он на работа	смочь взламывать на я он быть работать спутник аааа	мочь 1ps мочь сломать clf clf.сенсор clf clf.стучать 2ps работать2 занято
узкий	узкий	clf clf.тонкий
вот уже не думать что из топор такой вкусный каша мочь получаться	получаться вот думать каша уже такой не мой вот топор что	<dact> у-ж н-е думать не что и-з топор2 так хорошо <dact> мочь готовить
вс вокруг начинать зеленеть и цвести птица прилетать	начинать прилетать птица вокруг и зеленеть вс цвести	все круговое движение начать зеленый начать цветы птица
а однажды в ателье зайти женщина в возраст она долго рассматривать я задавать вопрос а потом сказать что быть бы неплохо она сын познакомиться с такой девушка	потом а а она в женщина вопрос ателье познакомиться сказать	и вдруг 3ps входить 1ps женщина возраст и пристальный взгляд 3ps вопрос.задавать 1ps потом 3ps отвечать 1ps б-ы poss 3ps сын 1ps девочка соединять знакомить
девочка она не понравиться	она девочка понравиться не	девочка мама смотреть не нравиться
в предыдущий видео мы говорить о то что мы потреблять слишком много разный вкусный еда но организм не мочь потратить весь этот энергия	еда весь но предыдущий не этот разный о потреблять энерги	давно видео2 мы 1ps рассказывать 2ps что еда множественный еда некоторый вкусный а тратить indx электричество внутри.себя не мочь уже
легкий	легкое	легко2
познакомиться я предлагать и я становиться заниматься резьба	заниматься я предлагать я познакомиться я резьба и заниматься	знакомить 3ps предлагать 1ps 1ps заниматься резьба2 карьера
когда в первый раз участвовать совсем ничто не понятно	раз участвовать когда в совсем не первый понятно ничто	раз <nums> куда не понимать первый второй третий
у крашеный волос цвет исчезать	у исчезать крашеный цвет волос	волосы что крашеный цвет3 исчезновение
давать ждать	ждать давать	нейтр.имп ждать2
вопрос вводить ли свой ребенок в сообщество глухой приводить ли на праздник участвовать ли в мероприятие	ли ли вводить ли на мероприятие ли в вопрос участвовать сообщество в ли	вопрос 2ps свой дети 2ps включать мир2 глухой проводить мероприятие праздник участвовать
самый плохой что это в климат краснодарский край это ветер	край край самый что это климат плохой в ветер краснодарский это курорт сам	плохой крупный что indx климат краснодар территория ветер
спать далеко это я дениска	спать я далеко дениск это я	какой спать продолжать 1ps <dact> имя
я заходить в строка продавец туда заходить	заходить строка продавец туда в заходить я заходить я	1ps зайти строка продавец
рассказывать про человек про то как я здесь рождаться и про вс остальное	про рождаться я и про рассказывать все про я человек как то з	будет о человек pl разнообразие 1ps здесь родить много разнообразие рассказывать будет
весь и у я быть удобный защитный средство	удобный у я быть средство и весь защищный	все4 и себя есть удобный защита прятать защита
весь другой животное очень взволноваться	другой взволноваться очень животное весь жить	все другой животное pl очень волнение2
он просто оглушать я	он просто я оглушать я	слышать звук
после урок идти к ребята	после идти к урок ребята	поздно урок приходить дети <dact>
так вот третьяков построить трехэтажный здание школа а рядом еще больница построить	вот так больница еще а построить трехэтажный рядом здание третяков	3ps т-у создавать2 этаж <nums> и больница2 был строить clf clf.расположение clf.объектов clf.в clf.пространстве
почему это слово код являться популярный во весь мир	являться почему популярный весь во мир этот код слово	почему это слово <dact> популярный2 <nums> называть мир2
хорошо пока	пока хорошо	хорошо пока хорошо
мать обещание не сдерживать и после окончание школа оля уезжать в чужой город и там и оставаться	обещание мать и после и город уезжать и не там окон	мама 3ps алкоголь и проходить школа <dact> уезжать другой чужой город и indx зафиксировать
к пример я экскурсовод кто не приходить человек так называть экскурсант	я называть человек кто пример приходить к так экскурсант я экскурсовод	представление 1ps <dact> clf clf.толпа clf.движется clf.loc 3ps имя называть <dact>
я под кровать за двадцатьлет не то что созревать я там вполне перезревать	под кровать там двадцатьлет не под перезревать я я что	1ps лежать <nums> время 1ps детство уже уже изменять взрослый будет
это федеральный государственный образовательный стандарт	это государственный федеральный стандарт образовательный муниципальный	это poss 3ps государство печать наука, образование
я с она очень согласный	согласный очень с она я	1ps мнение согласие
можно слепить снеговик	снеговик можно слепить ось	мочь делать <dact> шар pl
я думать что такой курс давать глухой новый возможность	новый думать курс давать глухой такой я возможность что я	1ps думать что курс давать новый возможность для глухой
в-третьих это огромный количество энергия который обрушиваться на мы и мы не знать куда он потратить	куда обрушиваться потратить который не огромный это мы энергия и	третий еще это большой clf clf.поступление clf.энергии электричество это множественный clf clf.поступление clf.энергии 1ps тратить куда трудно
мой учитель сказать женщина у она дочь со сломать позвоночник что это не причина отказываться от радость плакать не нужно	она не она плакать позвоночник сказать от что она не нужно у отказ	мой учитель имя дактилирование 3ps был сказать у 3ps был дочь с позвоночник сломаться 3ps говорить это н-е причина н-е радоваться плакать не
в магазин нет сыр	магазин в нет сыро	магазин <dact> нет2
не предлагать я ехать	предлагать не ехать я я	просить уважать 1ps 1ps предлагать 3ps еда не.нужно
общий представление о белок жир и углевод мы мочь получать в лаборатория однако у мы в организм весь устраивать намного интересный и сложный	и однако у лаборатория и весь представление белый получать	это общий мочь получать только2 лаборатория poss 1ps внутри.себя все еще интересный и сложный
нет хорошо так мой подруга быстро бегать не уметь	быстро мой не бегать так хорошо знать простой не хорошо нет подруга мой	не poss 1ps друг быстрый бежать не знать
утро принимать два капсула после еда вечер за минута до ужин	после минута до вечер утро два принимать капсула ед за	утро еда все4 clf clf.принять clf.две clf.капсулы вечер2 будет еда <dact> з-а <nums> минута будет еда
они бродить до утро по улица а потом поехать на вокзал и снова они место быть рядом	утро потом они и а вокзал снова место до на быть	согласиться прогулка с.вечер.до.утро потом вместе clf clf.два clf.человека clf.идут вокзал2 и попадать место сосед
мы не смочь поймать рыба	смочь поймать не мы рыба	1ps рыба схватить не мочь
у я двое слышать ребенок	у слышать двое ребенок я я	1ps у 1ps дети2 <nums> слышащий
мы вс восстанавливать	восстанавливать вс мы	не.переживать
давать подумать о то что вы написать	давать о то о вы написать что подумать вы	поэтому нейтр.имп строчка pl думать
в магазин пойти	магазин пойти в	магазин пойти
они собираться и общаться на жестовый язык	общаться жестовый собираться они язык на и и	3ps собираться проводить говорить.на.жестовом.языке
я только русский и английский язык	русский английский я только язык и я	1ps <nums> русский английский 2
следующий тот кто не знать жестовый язык	следующий не жестовый знать тот язык кто	следующий2 кто жест не знать
я быть в италия	быть италия в я	италия2 1ps был
саша сломать нога из-за это сегодня не прийти на день рождение	день рождение сегодня приходить не саша это на нога сломать нога	<dact> <dact> сломанный это 3ps не мочь приезжать день.рождения clf clf.человек clf.прийти день.рождения
жизнь закалять и я благодарный весь кто поддерживать я в непростой время помогать подсказывать	поддерживать я помогать кто весь я и непростой время помогать	жизнь 3ps учить2 1ps 1ps благодарение все кто был сосед 3ps поддерживать 1ps 1ps тяжелый время 3ps подсказывать 1ps
да раз в неделя заниматься	заниматься раз неделя да в	indx неделя <nums> раз <nums> учиться
здравствовать	здравствовать	приветствовать здравствуйте
я она слушаться потому что считать что она становиться я мама я она даже так называть	она она слушаться она называть она потому так я я что она считать	1ps согласиться надеяться <dact> <dact> poss 1ps мама тоже 1ps иметь тема <dact>
еще когда человек полностью задыхаться мы останавливаться	полностью когда задыхаться еще останавливаться останавливаться человек мы	еще когда человек полный задыхаться2 останавливаться полный тихий
совсем отрицательно	совсем отрицательно однако	следующий3 совсем отрицать
здесь мы также продолжать заниматься в различный кружок проводить тренинг и разнообразный мастер-класс	и проводить здесь мастер-класс здесь различный продолжать заниматься  трениров	здесь тоже продолжать разнообразие кружок мастер класс <dact> разнообразие
либо родитель не отдавать все себя ребенок и не объяснять смысл слово на жестовый язык	и не либо ребенок на жестовый отдавать объяснять себя не родитель	или родной отдавать.всего.себя говорить на жестовом языке рассказывать мысль слово
к сожаление не весь семья такой дружный	сожаление к семья дружный такой весь не	сожаление все семья такой дружба
я не мочь ты отпускать поэтому я купить билет до твой город	отпускать я поэтому купить до я город билет мой не мой я тво	1ps 2ps свобода не мочь 1ps кормить билет до poss 2ps город
только вы так странно одевать	вы одевать так странно только	одежда3 просматривать одежда3 странный
где-то или месяц	месяц где-то или где-то месяц	месяц <nums> месяц <nums> месяц <nums> месяц 3
вода в речка быть прозрачный так что можно быть увидеть камень на день	быть так прозрачный на быть можно в видеть вода камень что день	вода река прозрачный видеть камень четко
у мы с другой быть секрет друг от друг	другой у быть секрет друг другой с от другой у мы быть	1ps друг вдвоем секрет иметь делить ноль
у я в план в дальнейший объявлять о возможность проведень курс обучение	план я у дальнейший возможность о в в в в обучение курс объяв	у 1ps есть план 1ps уже ранее объявлять о poss 1ps план обучать2 <dact> обучать2
весь человек разный у весь разный работа и характер разный то что я объяснять это не готовый формула успех главное я давать вы правильный направление	разный я разный я разный я разный и разный	человек pl разный работать2 разный характер разный поэтому 1ps объяснять это готовый2 успех все4 1ps выполнять главный направление правильный clf clf.двигаться clf.в clf.направлении
нужно что-то решать но я действительно не знать с что начинать	знать решать начинать действительно но что-то с не нужно что я	думать решать нужно действительно 1ps не.знать что с что начать
мы договариваться встречаться в определенный день я приходить рассказывать о свой проект и сказать что деньги пока на он нет	день я и деньги встречаться пока приходить рассказывать он что проект о	1ps договор число попадать 1ps <dact> приходить это встречаться 1ps разговаривать2 да согласие 1ps что проект 1ps есть а деньги временный нет2 1ps желание <dact> <dact> деньги зависеть
я не понимать математика	понимать не я  математик	математика 1ps не понимать нет3
неполный блокада дыхательный путь	блокада путь неполный дыхательный пропускной	н-е полный не останавливаться дышать
наверное вы подумать что быть лишний окошко	быть что упорядочивать вы подумать лишний окошко наверное лишний что бы	наверное думать еще лишний
настоящий	настоящий	настоящий
бабушка и дедушка родитель папа а мама и папа родитель катя и антон	и антон родитель мама и и мама и мама а мама	бабушка2 дедушка это родители папа poss 3ps мама папа родители poss 3ps <dact> <dact>
еще он замечать бабочка медвежонок никогда не видеть ничто такой же яркий разноцветный красивый и удивительный	видеть никогда еще удивительный и не видеть ничто такой	еще замечать бабочка2 раньше медведь видеть никогда похоже яркий цвет разный и красивый удивительный
весь животное в лес смеяться над мышонок	над животное над весь лес мышонок смеяться в	все животное pl лес2 смеяться угрожать2 <dact> мышь2
мелкий	мелкий	мелкий2
они связываться со спонсор который попросить предоставлять скидка или раздавать мыло бесплатно чтобы ребенок использовать он для мытье рука	они рука для попросить который или со он предоставлять они использовать	уже контактировать pl <dact> спонсор контактировать pl просить 3ps скидка или бесплатный раздавать мыло сдать pl дети2 умыть руки использовать pl уже
следующий акселератор	ак сенсатор следующий	следущий3 <dact>
общий	общий	общий
мой попугай любить человек	человек мой любить попугай	poss попугай <dact> любить человек pl
акцентировать внимание именно на это	это именно внимание на акцентировать	<nums> до у 1ps 1ps интерес акцентировать.внимание дети2
вот и первый рыбка ерш	первый вот ершш и рыбка	первый рыба2 ловить <dact>
мой бабушка любить гулять ночь	гулять мой любить ночь мамашка	poss бабушка любить гулять ночь
получаться что один апсула с утро уменьшать аппетит особенно тяга к сладкий защищать от развитие метаболический синдром инсулинорезистентность а в дальнейший сахарный диабет усиливать эффект насыщение и защищать от повторный набор вес	и а от утро защищать а и а от постоянн	успех капсула утро indx уменьшать2 следующий3 еда еще не.хотеть отдельный2 сладкий indx желание нет2 и защищать о-т о-т воспринимать и сахар <dact> конец и сильный увеличивать чувствовать сытый и защищать о-т обратимый вес увеличивать
я обожать что в мой работа нет однообразие всегда разный место человек информация посещать разный мероприятие	разный посещать мероприятие в разный что разный я информация человек разный все	обожать2 что 1ps однообразно так нет2 всегда2 разный место человек pl информация разный посещать.туда.сюда разный
антон настоящий старший брат он всегда защищать свой маленький сестра если кто-то в школа иногда пытаться е обижать	сестра кто-то защищать если е настоящий брат пыта	<dact> настоящий старший брат 3ps всегда защита свой маленький сестра забота случай что школа быть pl 3ps кто обида дразнить
и я становиться интересно быть ли подобный в москва	я становиться москва ли в и быть подобный я интересно	1ps интересный москва здесь есть отсутствие
человек не носить это платье потому что оно мало	платье этот человек не что этот носить потому мало оно что	человек pl н-е носить это платье почему это indx мало маленький3
здесь африка	здесь африкатура	здесь африка2
мочь быть чтобы деньги оставаться на потом но на самый дело весь человек разный и у каждый быть свой причина	оставаться быть самый у потом чтобы на и каждый дело причина	мочь быть что думать копить оставить желание н-о так 2ps pl человек pl разный причина свой pl внутрь
мучение	мучение	страдание
тонкий	тонкий	худой2
да	данный	да
в интернет быть список конкурс в свой город	свой быть в список интернет в конкурс город интернет город	интернет список соренование свой город
рано быть такой автомобиль красивый длинный с олень на капот	длинный на рано такой автомобиль капотовый с быть красивый олень	<dact> раньше красивый clf clf.длинный clf.автомобиль clf clf.фары <dact> олень clf clf.олень clf.лапы clf clf.олень clf.стоит
она начало что-то говорить да неожиданно замолчать	говорить она неожиданно начинать да что-то замолчать да	3ps <dact> девочка рассказывать случай неожиданно2 молчать
несколько год назад у она к сожаление умирать мама	назад у сожаление к год она несколько умирать мама	несколько лет назад2 девочка poss 3ps мама смерть жалость
пожалуйста помогать мы кто если не вы	помогать вы если кто не пожалуйста если мы	1ps просить 2ps помогать 2ps 1ps если 2ps кто дефицит
у мы весь переводчик первый категория и постоянно повышать свой квалификация	постоянно и повышать первый у категория весь повышать мы	у 1ps переводчик все первый <dact> и всегда расти карьера учить карьера всегда
он быть старый я на год и наш отношение быть довольно странный	старый отношение быть я год наш довольно быть странаный и наш	мальчик 3ps был старший 1ps н-а <nums> лет и взаимоотношения был странный
человек говорить не мочь но он модевать покачать голова	говорить но не он покачивать голова мочь человек модевать модевать	человек говорить не.мочь.сделать голова как голова кивать хорошо
невозможно	невозможно невозможно	невозможный
правильно	правильно	правильный
код собираться вперемешку	собираться вперемешкучка код	кода собрание смешанный
он так бояться	бояться так он	о-н так страх
я подумать у я получаться резьба заниматься	заниматься я у я получаться я резьба подумать	поэтому 1ps думать резьба2 успех как
в будущее мир глухой исчезать или нет	исчезать мир или нет глухой будущий в	думать будущее мир2 глухой исчезновение будет или не.будет
это не мой тема но я смотреть немного в будущее	немного в смотреть но тема мой это будущее я не но	это н-е poss 1ps тема но 1ps смотреть чуть-чуть будущее
это прекрасный возможность для человек с различный ментальный заболевание кто действительно не мочь трудоустраиваться и он нужно постоянный сопровождение	постоянный и кто он для этот действительно прекрасный сопровождение	это отличный возможность для человек pl разный pl умственный заболевание кто не мочь разделять не мочь трудоустройство 3ps нужно следующий следить
множество человек	человек множество	множественный человек pl
не понимать почему кушать что	понимать почему не что что не курать	2ps не понимать почему еда что
похоже откусывать сэндвич	откусывать сэндвич похоже	похоже <dact> clf clf.сэндвич clf.откусить
и вот изображение стекло запотевать он начинать он протирать и когда протирать начинать проявляться картина то что он хотеть	он хотеть он вот он когда начинать что изображение начинать картина прот	пример clf clf.изображение clf.размытое начинать вытирать когда2 вытирать появляться картина рисовать это соответствовать indx что 3ps желание похоже 1ps исправлять 3ps
также здесь рассказывать об история общество глухой о то откуда возникать жестовый язык	история возникать здесь также о рассказывать жестовый общество то глу	и 3ps включать похоже 1ps рассказывать 2ps история раньше глухой общество жестовый.язык2 возникать
если не помогать снова производить хлопок пока ни получаться	пока снова ни помогать получаться не производить если снова добираться	бесполезный новый clf clf.человек clf.выбить clf.инородное clf.тело clf clf.человек clf.выбить clf.инородное clf.тело чередовать глаза clf clf.инородный clf.предмет clf.вытолкнуть нужно
когда медвежонок просыпаться папа не быть только вода повсюду	медвежонок вода не повсюду просыпаться быть когда папа только	когда медведь маленький3 проснуться папа пусто повсюду вода
получаться при минимальный увеличение жир обмен вещество в организм замедляться в раз	при раз в раз увеличение в обмен вещество минимальный получаться раз активный организм	получаться clf clf.чуть увеличение <dact> увеличение clf clf.чуть получаться clf clf.огранизм clf.процесс <dact> медленно в 1.5 <dact> медленно
я переводить различный пара мероприятие	различный мероприятие я пара переводить	1ps переводчик разный урок мероприятие
а к кто обращаться	к обращаться кто а а	а обращаться кто
я обязанный знать военный дело	обязывать знать военный я дело обязывать	1ps обязанность знать правила военный дело
древолаз очень токсичный и бывать разный цветок желтый темно-зеленый красный черный но самый опасный золотой	зеленый разный зеленый очень зеленый красный цветок зеленый опасный	clf clf.лягушка clf.взбирается clf.по clf.дереву у 3ps есть вредить есть бывает видеть цвет3 желтый темный зеленый красный синий черный н-о сам2 опасный зеленый цвет3 золотой
вопрос кто входить в сообщество глухой	вопрос сообщество глухой кто входить в в	вопрос кто включать мир2 глухой внутри
четвертый ваш мнение	ваш мнение четвертый деньний	четвертый poss 2ps мнение
веко защекотать слезинка когда поезд тронуться но вдруг дверь в купе открываться и входить роберт	открываться дверь роберт когда в входить и веко купе за	слеза поезд clf clf.поезд clf.трогается вдруг clf clf.двери clf.купе clf.открываются мальчик clf clf.человек clf.идет то.же.самое <dact>
создавать	создавать	собирать
а куст кричать соловей чтобы тот еще крепко прижиматься к шип	кричать тот шипка еще а прижиматься а прикладываться креп	кусты clf clf.кусты кричать птица2 imp держать clf clf.тельце clf.птицы imp
мочь быть у вы быть какой-либо вопрос или хотеть подробность я готовый вы отвечать спрашивать	быть у мочь спрашивать я или хотеть какой-либо быть	может.быть у ps2 есть вопрос подробный мочь ответ спросить 1ps
нападать	нападать	напатать
из жир так же как и из белок строиться клетка оболочка мембрана без жир не образовываться поэтому часть жир идти на строительство этот мембрана и не давать мы энергия	и и и часть из так как энергия на белый не образовываться	<dact> indx и <dact> тоже строить клетки.организма indx без clf clf.оболочка clf.клетки это делать и-з <dact> это отдельный <dact> будет использовать строить clf clf.оболочка clf.клетки и электричество 3ps давать 1ps нет indx половина убирать
сделать такой ступенька на память красота	сделать такой на память ступочка опасность память такой	это indx ступенька был собирать памятник красивый
быть много направление где можно себя применять физкультура преподавание разный направление быть	быть физкультура где направление себя быть разный много применять	1ps какой физкультура направление считать3 преподавание направление считать3 любой разнообразие3 куда все есть
а инвалид нужно быть обязательно давать путевка дом отдых специальный больница	обязательно давать а инвалид специальный путевка нужно быть больница дом отдых	и а инвалид так нужно платить pl должен первый путевка отдых дать дом pl отдых дать специальность больница2
мой текущий рабочий деятельность мочь продолжаться до но вдруг я узнавать о болезнь или что-то случаться	я до продолжаться рабочий или деятельность болезнь о вдруг мой что	сейчас 1ps деятельность работать2 быть хорошо мочь до <nums> мочь быть н-о узнать болезнь что случай
это значит настоящий поэтому сейчас он не мочь	он мочь это не поэтому сейчас настоящий значить это	это настоящий сейчас не мочь
поэтому я хотя и оробеть но не до конец и весь продолжать посматривать на ефросинья петровна что же она будет делать далеко	продолжать и и я и и посмотреть делать конец до	1ps пока 1ps чуть-чуть страшный чуть-чуть взглянуть бабушка взглянуть делать что интересный взглянуть
по разный причина по сложный работа по ещ какой-то причина просто не хотеть	разный по сложный какой-то просто причина работа по причина не хотеть	разнообразие причина сложный условие труд ещё что-то не.хотеть
в сентябрь обычно тоже жарко	сентябрь в тоже обычно жарко обычно	сентябрь indx тоже
внешний	внешний	внешний
я не знать испанский язык	испанский знать я не язык	1ps испания2 язык 1ps не знать
я относиться ко весь одинаково хорошо	ко я одиночка хорошо весь относиться я	1ps все так хорошо отношение
один ребенок будет смотреть но он это не нужно	смотреть но ребенок один не он нужно это быть	смотреть не.нужно
мой профессия интересный и необычный	и необычный мой интересный профессия	poss 1ps профессия переводчик интересный необычный
однажды тамара присниться сон забросить деревня а там дочка и она звать тамара и просить скоро она находить	тамара тамара и тамара присниваться тамара и тамара тамара	и однажды 3ps девочка сон изгой2 деревня и дочь кто кричать мама pl быстрый 1ps успех
в-третьих помимо углевод жир и белок пища давать наш организм витамин и минерал который регулировать различный процесс	процесс углевод и который и давать организм наш в и пища различ	третий еда <dact> <dact> <dact> вместе еще 3ps давать 1ps плюс полезный <dact> что метаболизм правильно работать внутри.себя все
я должный уметь командовать отряд	отряд должный я командаовать уметь	1ps нужно знать пример группа военный руководить
я часто пропускать школа из-за то что сидеть с младший сестра	пропускать я часто школа младший с то сидеть что сестра из-за	1ps часто прогуливать школа почему 1ps сидеть вместе младший сестра
общий	общий	общий2
что хотеть сказать	хотеть что сказать сказать хотеть	желание сказать
бывать что в связь с погодный условие обледеневать и оборваться провод но опять же такой случаться редко	облетевать и такой связь в случаться но опять условие с погод	быть попадать <dact> мороз дождь быть clf clf.провод clf.pl провод clf clf.провод clf.порваться редко
так быть всегда сказать сова и это никогда не изменяться	изменяться так и не быть всегда так никогда сказать совеня	разговаривать2 <dact> пусть всегда ладно думать изменять не.будет2 ладно
через ассоциация мы постараться сделать так чтобы вы в свой город например в новосибирск находить филиал этот ассоциация и приходить туда	и город туда ассоциация чтобы постаться филиал постаться например через	1ps через содружество 3ps 1ps адрес список 1ps будет раздавать2 все это 3ps адрес свой новосибирск 3ps другой город будет приходить2
а если я не прийти домой папа и мама обязательно сообщать в милиция	обязательно если и а милиция приходить я не сообщать домой	1ps домой не будет родители должен полицейский милиция предупредить
лето сам себя нужно купаться	себя купаться сам нужно лето	indx лето обязательный купаться
когда наступать ночь они отдыхать	наступать ночь когда они они отдыхать	когда ночь начало отдых
это я очень нужно потому что я получать различный информация о музей город благодаря этот организация	информация получать организация я этот очень этот я необходимо музей благодар	1ps indx быть включать это нужда indx различный pl получать информация все получать вечный у 3ps содружество перечислять2 получать2 indx быть музей работать2 включать indx город страна indx 1ps вечный
мать девочка сильно выпивать после развод с отец и оля всегда сторониться ребята чувствовать себя обделять	всегда девочка после обделять сильно мать себя с мальчик развод девочка	мама poss 3ps девочка проходить расстаться папа сильный алкоголь и <dact> 3ps всегда2 <nums> лишний2
вода холодный или ты притворяться	притворяться вода или холодный вода притворяться тот	вода холодный или 2ps притворяться
благодаря вот этот механизм ускоряться снижение вес	механизм благодаря снижение этот вот ускоряться вес	благодарение это indx собирать indx успех вес худеть
дочка сидеть зажиматься в угол	дочка в зажиматься угол сидеть	дочь сидеть угол прятать
но иногда смотреть на человек и думать что у он жировой запас даже слишком много и пора останавливаться	у много но запас иногда и и останавливаться на смотреть слишком	видеть человек 3ps <dact> жировые.запасы куда хватит конец
мы с она знакомый	знакомый с она мы	1ps pl вместе знакомый
я приходить в тот школа в который среди слышать ребенок быть код приходить туда смотреть помогать	приходить смотреть среди я туда приходить который в слышать в	кто indx дети слышащий кода включать 1ps помогать 3ps 1ps приходить 3ps проводить indx приходить смотреть indx
обнимать и до следующий встреча	следующий до встреча и обнимать ограждать	обнимать все до следующий встреча пока
подключаться быть вы ждать	подключаться ждать быть вы подключаться ждать вы	ждать2 poss 2ps 2ps подключаться 1ps
вы быть получать различный поручение	различный поручение вы получать быть	желание пример поручать различный
я быть учитывать возможность ваш город	возможность я город учитывать быть ваш	1ps обучать2 потом потому.что город poss 2ps
также вы мочь находить я в соцсеть ВК фейсбук и написать я задавать вопрос я отвечать	отвечать я я я я я я написать также вопрос	кто узнать2 мочь 2ps 1ps соцсеть ответ в-к фейсбук написать вопрос 1ps отвечать
следующий вога клуб глухой	следующий вога глухой следующий клуб клуб	следующий2 <dact> клуб глухой
я сам глухой общаться на жестовый язык мой родитель а также бабушка и дедушка тоже глухой и мы нормально общаться на жестовый язык	нормально мой я и на и также язык мой а на говорить	1ps сам2 глухой poss 1ps говорить на жестовом языке poss 1ps родиетли глухой бабушка дедушка глухой 3ps pl говорить на жестовом языке нормально
если бы я не пойти работать переводчик я бы выбирать направление сурдопедагог и обучать бы ребенок с нарушение слух	нарушение я работать если я бы быть и не я	если 1ps поступать работать2 переводчик 1ps выбирать другой специальность направление <dact> преподавание обучать2 дети2 нарушение2 слух
да	данный	д-а
укус лори мочь вызывать анафилактический шок и даже смерть говорить что лори подражать змей ядовитый	ядовитый смерть и говорить анафилактический змей лор	это 3ps кусать мочь 1ps <dact> 1ps смерть мочь2 это осторожно <dact> 3ps копировать змея похоже
о нет ты не мочь поехать на королевский бал в такой вид	поехать на королевский такой о нет в вид мочь не бал ты так	нельзя уезжать королевский праздник бал такой 2ps
мы видеть что человек стоять взгляд испуганный	видеть человек стоять видеть взгляд испуганный что мы	1ps 1ps видеть человек стоять глаза какой clf clf.глаза clf.расшириться напуганный indx кашлять2 останавливаться
ехать нужно быть далеко но луиза не мочь пропустить такой событие	пропускать ехать быть такой событие далеко но не мочь едва	поехать далеко н-о пропускать3 не мочь
семья это труд друг о друг забота	друг друг семья труд друг забота о о этот	семья это труд делать друг.друга забота
например на помещение	например помещение на	пример комната комната
на седьмой место муравьед	место седьмой муравьед на	следующий3 <dact>
он вчера не купить мясо	вчера не он мясо купить	о-н 3ps вчера мясо покупать не был
он быть страшно но он стараться не показывать это	показывать стараться страшно но не быть он он этот	о-н был страх н-о стараться н-е показывать
жир сжигаться быстро и превращаться в энергия	быстро превращаться энергия сжигаться в и жир	<dact> огонь быстрый изменение энергия
и как раз когда мы общаться в фейсбука там быть человек по имя аркадий белозовский	там когда и аркадий белый оффбук как раз человек общаться им	<dact> <dact> связь когда фейсбук indx был беседовать indx имя <dact> <dact>
по-прежнему пусто	пустой по-прежнему	пустой то.же.самое
у я быть принтер	у быть я факс копия	1ps принтер2 иметь
а также углеводный пища потому что повышаться сахар и инсулин в кровь	а повышаться углеводный кровь пища также инсулин что и	плюс <dact> еда indx тоже почему сахар2 выше <dact> кровь тоже выше
для то чтобы вы быть заразный у вы не должно быть антитело	быть у не то должно антитело вы быть заразный у чтобы вы	если 1ps заразный 1ps необходимость внутри защита не иметь
мой жена тоже учиться в ЛВЦ она знать	в знать жена учиться тоже она ЛВЦ мой	poss 1ps жена лвц учить2 знать пример
в это институт учиться глухой и я там быть	я быть там и в глухой институт этот учиться я	институт глухой толпа есть indx это 1ps был indx
код из разный страна сразу узнавать друг друг радоваться начинать взаимодействовать друг с другой	друг друг друг начинать друг разный друг начинать друг страна узнавать с разный рад	глаз знать poss 1ps 1ps пример 1ps италия2 русский пусть <dact> 3ps одинаковый 3ps нейтр.имп радость clf clf.взаимодействовать общаться
следующий этап начинать копить на случай если оставаться без работа увольняться тогда что делать а резерв всегда быть	случай копить оставаться делать если следующий увольняться на быть	потом следующий все4 потом начинать копить вдруг 1ps не.работать уволиться что pl делать оставить есть
поэтому хром уменьшать тяга к сладкий	уменьшать поэтому к тяга хром  сладкий	<dact> уменьшать2 3ps тянуть 1ps сладкий
хорошо	хорошо	хорошо
абсорбция другой соединение хром незначительный и составлять мало	хром незначительный соединение абсорбция мало другой составлять и	<dact> соединение успех мало меньше <nums> процент
за вертолет платить кто будет	вертолет платить быть кто за борт	вертолет деньги кто будет
почему	почему почему	почему
у мой брат быть чистый носок	чистый брат у носок мой быть	poss 1ps брат чистота носки иметь
изменяться мир ваш семья друг и коллега весь изменяться	друг изменяться мир семья коллега и изменяться весь ваш изменяться друг	ваш семья мир изменить друг pl вместе работать все изменить будет
это агенство вообще мочь выделять переводчик на любой мероприятие вы же знать что вы по закон положенный переводчик поэтому не надо стесняться он просить	поэтому надо этот вы не агенство вы знать вы по вообще люб	это indx это выделить перевод indx любой деятельность что соревнование indx подать.заявление и обратиться 2ps перевод пожалуйста обслуживать все терпеть должен закон indx есть все должен обслуживать перевод
получаться я продолжать работать и плюс обучать студент будущий переводчик	продолжать и будущий я работать продолжать переводчик плюс обучать получ	1ps получать2 1ps продолжать работать2 оставаться2 продолжать еще работать2 плюс 1ps учить студент2 будущее переводчик
гордиться	гордиться	гордый
вдруг ларсить замечать вдалеке свой папа	вдруг вдалеке свой замечать ларшать папа переставать	случай <dact> замечать clf clf.вдалеке indx папа видеть
следующий рыба фуга большой круглый рыба с пятно	рыба рыба с рыба рыба следующий большой круглый фуг пятно следующий большой	изменить.направление рыба2 <dact> clf clf.рыба clf.круглая пятно pl clf clf.рыба clf.круглая
говорить голос и жест одновременно	говорить одновременно жест жест голос и голос	жестовый язык
привет	приветствовать	привет
это специальный группа слышать ребенок у который родитель глухой	слышать родитель который у глухой группа специальный ребенок это группа	это специальность группа дети2 слышащий poss 3ps папа глухой
верно	верно	правильно
во-первых в состав максимально эффективный комлпекс компонент экстракт гарциния и пиколинат хром	в во-первых комлпекс содержаться максимально компонент и экстракт	первый собирать indx есть тупик полезный общий <dact> и <dact>
она входить вытирать рука о полотенце	полтора рука вытаскивать о она входить о полтора	clf clf.человек clf.идет потирать.руки
вдруг он услышать в лес возмущать разговор зверь медведь заяц белок птица	возмущать вдруг медведь птица в зверь белый услышать	слышать indx лес что разговаривать2 <dact> что indx был разговаривать2 медведь возмущаться заяц <dact> птица множество смешанный
молчать	молчать	молчать
что за надоедливый крыса что ты нужно	надоедливый нужно крыс что надоедливый что за ты что	случай крыса2 вредный что желание
например масло коллаген и то что иметь глубокий увлажнение чтобы ухаживать за волос	глубокий увлажнение чтобы и за иметь например чтобы кол	пример масло ухаживать глубоко масло <dact> заботиться что был
я белый мишка с северный полюс	белый я полюс мишка северный с я	1ps белый медведь жизнь северный.полюс
приходить посмотреть дом рядом с лес там жить мальчик который играть в лес	который рядом лес в лес посмотреть приходить дом мальчик играть с лес там	приходить2 смотреть2 рядом дом indx мальчик жизнь территория близко <dact> indx indx мальчик был indx дерево pl игра
нужно поставлять ряд задача написать устав	поставлять задача поставлять нужно ряд написать устав устав	нужно поставить pl список задание pl <dact> список список <dact> закон
чужой	чужой	чужой
у я в голова не укладываться вообще вот такой вот случай быть	случай вот такой у вообще я быть не в вот голова	1ps 1ps тупик ап попадать случай был
сделать маленький десятисекундный репортаж и показывать	десятисекундный и показывать маленький репортаж сделать репортаж	видео2 маленький4 <nums> секунда отправлять 3ps новости показывать
запираться	запираться	выключить
скоро вс починять	скоро все начинать	скоро чинить готовый будет
следующий лебедь очень красивый птица который жить пара и с который у мы связанный много представление о любовь	который птица лебедь очень у связывать жить о который	следующий3 <dact> clf clf.птица clf.машет clf.крыльями clf clf.длинная clf.шея красивый clf clf.два clf.лебедя clf.склонили clf.друг clf.к clf.другу clf.головы всегда2 clf clf.два clf.лебедя clf.склонили clf.друг clf.к clf.другу clf.головы милый видеть всегда2 внутри любовь2 clf clf.два clf.лебедя clf.склонили clf.друг clf.к clf.другу clf.головы clf clf.птица clf.машет clf.крыльями
и я весь время поглядывать на ефросинья петровна	петровный и время я поглядеть на ефросинье весь	1ps всегда2 видеть взглянуть бабушка 3ps делать что
я показывать презентация	показывать презентация я	1ps показывать мультимедийная.презентация indx
привет я звать елфимов светлана вот мо жестовый имя	звать вот я привет я жестовый имя светлана ельфимов	аплодисменты 1ps имя <dact> <dact> poss 1ps жестовое.имя sn
сейчас жестовый язык популярный в мир слышать	популярный мир сейчас в жестовый слышать язык слышать	сейчас жест известный indx мир говорить
соглашаться	соглашаться	согласие
в Instagram быть группа мама в дело	быть дело в мама в группа в группа быть интернет	в instagram 1ps есть группа мама дело indx
даже к подросток нужный другой подход	другой к подросток подход даже нужный другой	даже подросток переезд средний2 другой работа будет
например я работать в технологический музей видео гид и у они там очень хороший финансовый положение	очень и они я положение финансовый работать например в я	пример 1ps делать технология музей и indx поручать видео <dact> indx финансирование2 лучше
перечить она не сметь	перечить не она сметь	перечить
следующий жестовый пение театр глухой история или рассказ на РЖЯ	история или на следующий глухой ржая рассказ жестовый пение театр	следующий2 жест пение театр глухой poss 3ps история жест рассказ <dact>
ребенок не осведомлять об это почему	осведомлять почему ребенок это не об осведомлять	3ps pl не знать почему
оказываться очень важный знать что у он быть друг	оказываться важный знать быть очень он друг что у очень	оказываться очень важный если знать у 3ps есть друг
что нужно делать	нужно что делать делать	что делать нужно
привет	приветствовать	привет
или написать свой мнение	свой или написать мнение написать свой	или poss 2ps pl мнение написать
это подходить то кто хотеть но не мочь копить	хотеть подходить копить не но кто мочь это то	есть кто желание н-о не.получаться копить подходящий объяснять
смерть дорогой цена за красный роза восклицать соловей	дорогой восклицать смерть цена соловей красный роза за красный	смерть дорогой clf clf.вносить clf.деньги обмен2 красный цветок отвечать птица
отражение роза в серебряный зеркало отражение роза в недвижный вода вот каков быть роза расцветать на верхний побег куст	вот роза верхний зеркало отражение вода каков расцветать роза	типа река отражение цветок нежный сиять так2 нежный светлый был цветок расти кусты clf clf.цветок clf.распукается clf.медленно
вопрос как вы относиться к инклюзивный образование когда глухой и слышать учиться вместе	когда инклюзия и слышать относиться к глухой вопрос учиться	вопрос инклюзия образование2 говорить глухой вместе poss 2ps относиться как
и самый сложный это сам человек	сложный самый самый человек это и самый	сам2 сложный это человек pl сам2 сложный
старый солдат идти в отпуск	идти старый в отпуск солдат	старый солдат идти отпуск
следующий зима	следующий зима	следущий весна
нормально весь	нормально весь	нормально
восхищаться	восхищаться	восхищаться
у слышать билет стоты дорогой	дорогой у слышать стота билет	у слышащий стоимость деньги больше
и что же теперь делать раз нет	раз нет же делать что и теперь делать же	отсутствие pl что делать
ах какой счастие восклицать он	какой он восклицать ах счастие	счастье какой счастье кричать
