Russian	Predicted	Truth
а когда дед мороз вернуться домой маленький дед мороз приходить к главный и сказать а я то вон в лес тоже подарок раздавать	вернуться маленький приходить сказать то я дед мороз раздавать домой глав	indx дед.мороз clf clf.группа clf.переместить домой clf clf.группа clf.переместить дед.мороз маленький встретить приходить обращение главный 1ps был лес подарок clf clf.перечислять
а мачеха лишать я весь радость	лишать радость весь я весь матч фехха	мама второй 3ps все радость давать 1ps ноль
зачем я хотеть изменять свой привычка тратить и начинать копить	начинать свой тратить изменять хотеть я копить привычка	зачем желание изменение все4 привычка тратить все4 желание именение привычка свой изменение тратить и копить думать
оказываться впервые это появляться в америка	появляться оказываться впервые америка это	америка есть poss 3ps 3ps рассказ 1ps интересный америка первый прогресс
я вчера не стирать белье	стирать я вчера белье	1ps вчера стирать <dact> не был
она один за другой скидывать с себя туфля и прямо в один чулок подходить к дверь и у я от радость заколотиться сердце	сердце подходить один я сердце радость туфля один она дверь один	обувь2 убирать чулок бродить дверь 1ps думать радость 3ps скоро открывать.дверь сейчас скоро радость сердцебиение
тогда как	какой-то	<dact> дальше <dact>
заиграть первый луч солнце а друг уже у река	солнце уже река заигрывать луч друг первый река друг	утро солнце друг уже рядом река
я весь устраивать я быть интересно учиться и скоро я уже сам начало выполнять даже сложный заказ	заказ я я устраивать начало сам выполнять сложный я я в	1ps спокойный2 1ps был интересный учиться и время clf clf.время clf.идет 1ps уже сам2 получать даже сложный 3ps заказывать 1ps
мы отдыхать	мы посещать	мы отдых
нигде	молчико	<dact>
почему	переставать	почему
он уметь кататься на лыжа	он кататься лыжа уметь	3ps знать лыжи
я не понимать то ли она плакать то ли смеяться	понимать она то смеяться плакать то я	1ps видеть не понимать 3ps плакать или смеяться
в общий немного эмоционально получаться	немного общий получаться эмоционально	результат эмоция давать
сегодня мы разбирать ещ один опасный ситуация связанный с дыхание	опасный один связанный дыхание мы ситуация разбирать сегодня еще	сегодня объяснять ещё <nums> опасность связать дышать
ты я не только разозлить но еще и расстраивать	расстраивать разозлить я еще еще расстраивать ты	2ps н-е только2 злость 1ps и плюс 1ps депрессия
хорошо радоваться тогда и дочь быстро поправляться	радоваться быстро хорошо дочь поправкаться	пусть радоваться влиять 3ps дочь быстро здоровый будет
например в россия быть свой традиция	свой россия быть традиция например	группа пример россия есть свой традиция
мочь быть и я вы помогать	мочь быть помогать вы я	мочь быть говорить 1ps помощь
сейчас мочь даже слышно в микрофон	мочь слышно микрофон сейчас я	мочь быть немного слышать микрофон
кролик увидеть в цветок фея	кролик увидеть цветок фея	кролик что цветок и <dact>
он долго плыть и замечать вдали берег	он берег давать плыть замечать долго	долго clf clf.плыть clf.на clf.бочка замечать видеть indx clf clf.берег
жаль что я туда вс равно не попадать	равно попадать я жаль весь	жалость 1ps тоже indx попадать невозможный
не весь похоже понимать как это делать для себя а не для другой	похоже другой весь понимать себя это делать	себе делать похоже все не понимать как 1ps для 3ps делать
он отравляться	он отравляться	яд
много гриб собирать мальчик в лесной часто	собирать много часто лесной мальчик гриб гриб	много гриб собирать2 лес
без видео плохо но ладно я вы рассказывать сам история про англия	сам англия плохо история я плохо рассказывать хорошо видео вы	видео2 indx плохой 1ps 2ps 1ps рассказывать 2ps англия indx <dact>
он замечательно п к печение любой форма например в вид зв здочка лочек	форма любой например вид он печение например замечательно лочка замечательно з	это 3ps идеальный печь печенье <dact> вкус любой это 3ps уметь форма звезда ель разный pl
это глагол прилагательное	прилагательный глагол это	<dact> <dact>
к себя он приглашать я бояться но однажды он напрашиваться ко я на чай и увидеть мой условие жизнь предлагать пожениться и переезжать к он	он бояться он я условие приглашать жизнь он я увидеть сво	1ps себя дом страшный 1ps приглашать 3ps н-о вдруг о-н 3ps обратиться 1ps imp чай пить о-н 3ps видеть 1ps poss 1ps условие2 все жизнь видеть imp жениться и переезд к 3ps
и вы обязательно нужно давать ответ рассказывать	ответ вы нужно давать рассказывать обязательно	2ps pl обязательно нужда ответ pl рассказ pl ответ pl
когда мы отжимать волос вода на они оставаться	оставаться вода мы отжимать волос они	н-о 1ps жать вода clf clf.вода clf.на clf.волосах что необходимость вода оставаться indx есть
хотеть продолжать тема созависимость пренебрежение себя	продолжать хотеть себя зависимость пренебрежение тема продолжать	привет
пищевой волокно связывать большой количество вода в кишечник превращать е в гель который затрудянуть усвоение углевод что сказываться на снижение уровень колебание сахар в кровь	большой е колебание гель превращать волокно большой е	еда волокна успех связь3 только2 больше жидкий вода кишечник успех изменять <dact> и успех <dact> indx конец и успех 3ps давать 1ps уменьшать2 уровень колебание кровь
в строчка выбирать вариант или	выбирать вариант строчка	строчка связать <nums> 2ps выбрать <nums> ответ
когда появляться проблема нужно быстро придумывать как они решать	быстро проблема решать необходимо проблема появляться придумывать они быстро решать	проблема2 появляться быстро решать что придумывать быстро решать
потом я становиться искать какой-нибудь конкурс и наш л один который проводить среди слышать проводиться он два или три день в общий сложность	проводить общий я слышать три какой-нибудь день л два	1ps искать соревнование indx говорить соревнование 1ps все включено это все включено говорить соревнование <nums> день <nums> день <nums> факт2 indx дактилировать
у я быть я крутой у я быть связь	быть крутой связь я я быть я быть я	1ps мочь круто 1ps связь2 есть
я тоже хотеть ходить на бал	хотеть ходить я бал балто	1ps тоже желание посещать pl clf clf.пышная clf.юбка танцевать <dact>
мы знать это животное по мультфильм оно выглядеть так мило что мы и не думать о то что оно опасный а оно опасный	опасный знать оно оно животное опасный выглядеть мы думать оно оно	знать вы животное2 мультфильм2 интересный clf clf.милая clf.пушистая clf.мордочка милый 3ps думать неопасный н-о 3ps опасный есть
наш организация существовать с го год	существовать наш год организация гон	это poss 1ps pl организация существовать уже <nums> год
видеть по-разному	видеть по-разному	видеть разный
второй шаг	второй шаг	второй шаг <dact>
что вообще мочь сделать мы счастливый легко и быстро	быстро быстро счастливый быстро мочь мы быстро сделать вообще мочь	как вообще что влиять на 1ps мочь мы делать счастье очень легко2 быстро2
подруга рассказывать о свой проблема я тоже поделиться свой	рассказывать свой проблема поделиться свой я свой подруга рассказывать	друг 3ps рассказывать 1ps собственность проблема2 3ps рассказывать 1ps 1ps тоже 1ps рассказывать 3ps делить
хорошо	хорошо	хорошо
немного зима посмотреть и лето быть	немного зима посмотреть лето быть	немного зима смотреть2 лето есть
хитрый	глупый	хитрый
номер три это животное который называться древолаз	животное номер животное называться который три это древолаз который	еще есть животное2 назвать <dact>
а человек видеть мир по-разному	мир человек видеть по-разному	а человек pl видеть различный
в год в павловск построить ленинградский восстановительный центр	восстановительный павловск центр построить восстановительный ленинградский центр павловск восстанов	смотреть <nums> год <nums> год павловск <dact> indx стройка clf ленинград восстанавливать центр
мой бабушка не любить гулять ночь	любить гулять ночь мой бабушка	poss 1ps бабушка2 не.любить гулять ночь
нет так нет ну и ладно	плохой я	нет2 так нет2 н-у
такой человек называть элита	элита такой человек называть	новый все человек pl назвать <dact>
сейчас я видеть весь больше и больше небольшой команда который пытаться что-то делать как-то развиваться	развиваться больше видеть больше сейчас больше небольшой пытаться больше делать в	сейчас всё 1ps видеть больше маленький3 команда и-п сам2 достигать так развивать
ребенок весь понимать	весь ребенок понимать	все дети понимать2.наизусть
няня весь собирать и выбрасывать а мальчик давать новый белый с блестящий мех	собирать белый няня мальчик выбрасывать новый весь белый блест	няня2 ладно собирать2 выбросить2 мальчик давать новый белый мех блестящий
для кто-то нужно утяжеление для кто-то чтобы быть разглаживание	быть нужно кто-то утяжеление кто-то кто-то	<dact> кто тяжелый clf clf.волосы clf.тяжелые <dact> кто clf clf.волосы clf.гладкие clf clf.волосы clf.лежат clf clf.волосы что был
начальник говорить мы же готовый он взять у мы быть такой рабочий место но по факт человек с инвалидность никогда не пойд т на это место	начальник взять быть рабочий факт он говорить это место т человек так	начальник говорить мы готовый принять такой место у 1ps есть приглашать но п-о факт2 никогда это место инвалид вступить.не
ты должный позвонить мама а то она будет беспокоиться	она позвонить то беспокоиться должный будет позвонить мама я	2ps должен мама 1ps звонить.по.телефону 3ps 3ps волнение будет
я сидеть в свой комната учиться не пойти но жить на что-то надо быть	жить надо быть пойти я комната свой что-то сидеть у	всегда2 сидеть комната учиться нет нужно деньги жизнь
я обращаться и в другой место например в вога и там я тоже оформлять письмо поддержка такой образ уже они у я быть несколько	обращаться например поддержка я они другой например быть я	другой pl посещаемость надеяться indx и 1ps тоже <dact> 1ps обращаться <dact> тоже indx 3ps поддерживать 1ps печать 1ps повезло clf clf.складывать clf.письма clf.вместе уже
я не нравиться яркий одежда	яркий я нравиться одежда	1ps яркий светлый одежда2 не нравиться
глупый	глупый	дурак
сейчас для наш человек это возможность действительно заниматься любимый дело	наш действительно возможность сейчас это человек заниматься дело любимый	сейчас мы человек pl это возможность действительно работа любить работа
если педагог видеть что он разговаривать хорошо и весь понимать то он без проблема идти в отделение и учиться год	отделение он хорошо понимать разговаривать работать видить идти весь педагог	если смотреть ребенок разговаривать2 хорошо понимать все <nums> подразделение год <nums> учить2 не
потом домой приходить и мама просить еще урок проводить	проводить приходить еще просить домой урок мама	домой мама еще считать3 уроки
например двое мой ребенок говорить на жестовый язык	говорить мой двое ребенок жестовый язык например	дополнение пример poss 1ps дети <nums> глухой не говорить на жестовом языке
почему у мы в россия это не популярный	популярный россия мы это	1ps россия популярный нет2 почему
журналист просто бер т этот новость и публиковать на сайт с красивый картинка	публиковать сайт этот журналист красивый т берить новость картинка	1ps взять публиковать 1ps отправлять 3ps <dact> красивый картина
я жить в краснодарский край	край краснодарский жить я я	1ps жить кавказ место краснодар территория
нужно изучать основа чтобы иметь общий пердставление о они чтобы экскурсовод мочь об этоя рассказывать	они общий пердставление мочь изучать рассказывать основание нужно это	основной2 нужда изучать что общий получать воображение 3ps pl рассказ indx будет экскурсия человек экскурсия человек
я вы совсем не знать но я кажется готовый смотреть в ваш глаз вечность	знать ваш кажется я ваш смотреть я готовый совсем я ваш	дорогой девочка знакомый не 1ps 2ps совсем не знать н-о 1ps казаться 1ps poss 2ps глаз pl готовый зрительный.контакт вечность
а этот мужчина быть сантехник который чинить прорыв канализация и который обливать дерьмо тома давать он халат муж и разрешать подождать пока он привозить чистый вещь	этот он давать жилье который поджигать прорыв давать жилье санитар	а мужчина2 это кто сантехник <dact> сантехник 1ps исправлять 3ps туалет канализация clf clf.облило clf.из clf.канализации грязь туалет <dact> для халат муж и зафиксировать пока приносить чистый poss 3ps одежда3
скоро быть праздник	быть праздник скоро	скоро будет праздник
пока спасатель ехать мальчик сидеть рядом и следить	мальчик рядом следить сидеть спасатель ехать следить	пока спасать clf clf.человек clf.прийти 3ps мальчик рядом следить н-о жалость
весь целый весь пока	целое весь весь весь	воздушный.поцелуй аплодисменты
усердный	усердный	усердно.трудиться
открываться дверь	открываться дверь	открывать.дверь
он мочь бить себя по грудь или по стол пытаться показывать что он плохо и нужный помощь	бить себя он показывать пытаться помощь он нужный плохо стол	получаться 3ps clf clf.хлопать clf.по clf.грудь clf clf.хлопать clf.по clf.стол тоже показывать все 3ps помогать 1ps тоже плохой
представлять что инициативный группа хотеть разрабатывать проект который помогать избавляться от этот проблема и не давать она развиваться	она хотеть избавляться представлять проект инициативный разрабатывать проблема этот да	ладно группа гап делать indx проект проблема2 убирать живот развитие нет проблема убирать
жертва это когда вс что ты делать ты делать в ущерб себя	делать делать весь ущерб себя делать это делать жертва мы	<dact> называть <dact> что делать 1ps делать отдавать.себя себе думать нет
медвежонок плыть на льдина	медвежонок плыть льдина	медведь маленький3 clf clf.круглый clf.предмет clf.плыть clf clf.толстый clf.лед <dact> clf clf.запрыгнуть clf clf.на clf.четырех clf.лапах плыть
я этот никто не учить	этот никто я узнавать	1ps научить 1ps никто
например дма она заставлять она делать самый тяжелый работая	она самый заставлять например работать она делать тяжелый дма например	например дом самый сложный тяжелый труд clf clf.сесть clf.на clf.шею
на улица быть тепло и мальчик хотеть пойти гулять однако начинаться дождь	начинаться гулять дождь улица быть мальчик хотеть тепло пойти	indx смотреть улица теплота мальчик желание выходить гулять начать дождь
смотреть на вы	выглядеть смотреть	смотреть 2ps
что там	зявить	что indx
он облизываться	он облизываться	вкус облизывать
идентичность я глухой и ты глухой	идентичность глухой глухой глухой я глухой ты	следующий2 яг 1ps одинаковый 2ps 1ps глухой кровь2 2ps глухой 1ps одинаковый 2ps
если весь быть копить не нужно откладывать на всякий случай	нужно копить откладывать быть весь случай всякий всякий	копить 1ps копить не.нужно все есть это запас вклад
сура в адаптис плохой перевод в субтитр такой замечание	субтитр такой перевод плохой субтитр сур адаптис замечание	<dact> <dact> плохой субтитры перевод плохой замечание2
у я нет сила	сила я лить	1ps сила дефицит
этот верхний пункт сокращать но затратный ресурс быть всегда	пункт этот верхний сокращать ресурс быть затратный	это clf clf.деньги clf.уменьшаться <nums> расходы <dact> всегда постоянный тратить pl
здесь жить дружно поколение старший бабушка и дедушка средний мама и папа и младший ребенок катя и антон	средний жить антонон катать средний старший мать средний	indx дружба жить вместе <nums> поколение старший бабушка2 дедушка второй мама папа третий младший дети <dact> <dact>
я должный завершать еще пара важный дело пока	должный важный пара еще завершать дело я пока пока	1ps должен конец <nums> важный дело пока
понятно	понятно	понятый
сегодня мы продолжать разбирать программа slim	мы программа продолжать разбирать сегодня	сегодня2 продолжать <nums> исследовать <nums> д <dact>
но сначала давать разбираться как усваиваться пища	разбираться пища сначала усваиваться давать	н-о исследовать <dact> 1ps еда воспринимать <dact>
рассказывать еще	рассказывать еще	жестовый язык кто еще был рассказывать
терять	терять	потерять2
он приносить одеяло из дом и накрывать собака обращаться к взрослый за помощь	обращаться накрывать он взрослый помощь присылать дом собака оде	одеяло дом clf clf.взять clf.принести одеяло обращаться взрослый помогать 3ps 3ps
даже мэр город приезжать чтобы успокаивать мальчик	город приезжать попкаивать мальчик мэр	и даже <dact> город поехать гость 3ps 3ps успокоить 3ps 3ps pl
например компьютер ноутбук проектор стул стол и всякий вещь	например компьютер всякий проектор вещь стол например компьютер кресло	пример компьютер ноутбук проектор мелочь стул pl стол был
здравствовать	здравствовать	здравствуйте
сейчас я объяснять как и что	объяснять сейчас я что сейчас	1ps сегодня2 1ps рассказывать 2ps что <dact> это
она просыпаться и она быть очень тесно	она тесно просыпаться быть очень она	проснуться и тесный был нормальный тесный
идти дождь и мы решать оставаться дом и посмотреть фильм	идти решать оставаться дом мы фильм дождь посмотреть	дождь 1ps думать решать оставаться дом и смотреть2 фильм2
весь что она удаваться находить это работа дворник в соседний двор но больший она и не нужно быть главное что хватать платить за квартира а на ехать она надо быть совсем немного потому что она почти ничто не есть и похудеть до неузнаваемость	она она ехать она хватать она квартира она ничто быть плат	и все что мочь2 успех только2 работать дворник сосед indx территория н-о дворник достаточно квартира платить есть деньги еда должен нет много <dact> чуть-чуть еда нет ничего2 худеть видеть лицо узнать нет
кто она резать	резать кто она	3ps кто 3ps разрезать 1ps
что вообще представлять себя этот организация и зачем она нужный	она представлять нужный себя этот организация вообще	это организация здесь для что
видимо становиться больше сажать культура и из-за большой количество урожай он становиться собираться поздно	культура количество собираться видимо он больше становиться больше становиться урожай поздно са	больше clf clf.сажать clf.в clf.землю урожай собирать2 выше начинать позже собирать2
в это место очень много турист благодаря то что здесь много исторический здание	много то исторический это место много турист здание много очень очень	это место много 3ps приезжать путешествие <dact> почему это место2 много исторический clf музей разный
семья это много домашний работа	это много работа домашний семья	семья это много дом работать
но я никогда не встречать	встречать я я	1ps встречаться никогда
потому что нет общение нет любовь и понимание и он быть просто как собачка это очень страшно а у тот трое быть семья любовь общение и вот это реально до мурашки	общение общение общение общение трое быть общение это он реально соб	общение ноль2 любовь ноль2 обнимать ноль2 игнорировать2 одинаковый собака2 clf clf.собака clf.прислушивается папа иса indx боль 3ps pl общение это 3ps pl 3ps pl спасибо общение делить думать сохранение понимать спасибо папа папа 3ps clf clf.мурашки clf.по clf.коже
в ноябрь будет год как я официально работать переводчик	ноябрь переводчик год будет работать я официально работать	ноябрь официальный 1ps работать2 переводчик уже <nums> год
я ждать твой звонок но ты я не позвонить	ждать позвонить я ваш я я звонок	1ps ждать2 когда2 3ps звонить.по.телефону 1ps 2ps тоже 3ps звонить.по.телефону 1ps нет2
рядом с печень желчный пузырь который удерживать желчь до необходимый момент	необходимый рядом желчь желчь желчь пузырь желчь который желчь	печень рядом <dact> <dact> clf clf.желчный clf.пузырь indx <dact> действие оставить нужно clf clf.желчь clf.убрать
лев лишь рассмеяться	рассмеяться лев	смеяться3 лев смеяться смеяться3
интересно	интересно	интересный
я быстро получать обещать жилье но это быть маленький комнатка в коммуналка где сосед ввергать в шок при первый же встреча	первый я маленький получать это сосед ввергать жилье обеща	1ps быстрый получать дом это был маленький3 комната сосед pl квартира сосед pl все сумасшедший3 1ps взглянуть
осаня начинаться в конец октябрь в ноябрь или декабрь	начинаться декабрь конец октябрь осада ноябрь оканчиваться	всегда осень2 начинать октябрь последний3 ноябрь декабрь всегда изменить.направление
интересно так	интересно такой	интересный так
второй вариант частично да частично нет	второй частично частично частично частично вариант частично частично частично второй	второй половина да половина <dact> слабый
ничто из еда нет	еда ничто еж	еда indx pl ноль
я любить голубой цвет а мой сестра ненавидеть он	любить мой я он ненавидеть голубой сестра цвет	poss 1ps любить голубой цвет голубой poss 1ps сестра ненавидеть2
переводчик слушать речь и переводить на жестовый язык	говорить переводить переводчик речь жестовый переводчик язык переводить переводчик	переводчик слушать 3ps речь 1ps 2ps 1ps рассказывать.на.ржя рассказывать переводить рассказывать переводить
если бы у мы в школа россия знать что глухой ребенок из семья глухой свободно говорить на жестовый язык и он учить бы переход с жестовый язык на русский то в школа бы привыкать обучать на жестовый и у ребенок быть бы грамотный русский язык	язык жестовый привыкать говорить язык глухой язык свободно язык русский язык бы	что если б-ы poss 1ps россия площадь б-ы школа вокруг знать ребенок глухой семья глухой говорить на жестовом языке <dact> переезд школа б-ы привычка обучать2 жестовый язык поменять грамотность poss 3ps русский язык
веселый	веселый	веселый
первый вариант принимать такой как быть	первый такой вариант быть принимать	первый принимать такой2 как есть
а если с реб нком в семья общаться при помощь устный речь а жестовый язык считать ненужный это не совсем CODA	речь ненужный общаться ненужный язык совсем речь это тихо язык	а если есть кто дети2 мама семья глухой ребёнок дети2 родиться слышащий говорить2 жестовый.язык не.нужно говорить2 беседовать poss 1ps кода indx нет indx
этот чувство доброта и любовь появляться в человек сам по себя	сам появляться доброта любовь человек себя этот чувство	чувство добрый любовь появляться человек автоматический согласие
когда я забеременеть то так же работать до последний а потом еще и на дом брать подработка	последний работать брать дом то я еще брать подработка зарабатывать	когда2 1ps беременность 1ps работать до <dact> приближаться плюс дом получать pl работать
как становиться эмоциональный энергичный воодушевлять свой жизнь	жизнь свой энергичный воодушевлять становиться эмоциональный свой	как стоять эмоция энергия воодушевление свой жизнь как
год он лечиться и выздоравливать	год он выдоравливать лечиться	год <nums> лечение заболеть здоровый
ты знать кто я	знать кто я кто знать ты	2ps знать кто 1ps
также природа выделять жир роль запасной энергоноситель т е поступать жир пойти на образование энергия но только в случай крайний энергодефицит	роль случай запасной поступать запасной также е т энергоноситель	успех и плюс природа 3ps давать 1ps электричество <dact> <dact> indx 3ps отправлять 1ps н-а основывать электричество только2 если 1ps электричество недоставать
заболевать	заболевать	заболеть
дедушка помогать антон они вместе записывать весь история семья	антон весь семья вместе записывать дедушка помогать они история	дедушка 1ps помогать 3ps <dact> вместе писать записать все история семья
на это мероприятие приглашаться весь дама и королева который хотеть повеселиться и отдыхать вместе со я принц это королевство сын король и наследник престол	принц это принц приглашаться я королевство вместе мероприятие принц король принц	это мероприятие праздник приглашать все девочка кто мечтать желание веселиться отдых 1ps вместе 3ps 1ps принц руководить это территория сын король наследство дать 1ps престол
дотащить он мешок в лес и раздавать подарок весь животное они очень обрадоваться	он они раздавать мешок обрадываться весь очень доставлять животное лес	clf clf.принести indx лес и подарок pl каждый животное2 подарок все возбуждение
на концерт	концерт	зал
он лежать мертвый в высокий трава и в сердце у он быть острый шип	высокий он быть лежать сердце острый мертвый шип  трав	о-н смерть трава clf clf.птица clf.упала clf.в clf.траву сердце птица2 indx был острый шип
женщина любить носить шуба они тоже защищать от ветер	женщина носить защищать ветер любить шуба они	женщина pl любить носить шуба2 тоже включать ветер защита
снег растаивать потому что выглядывать солнце	снег солнце выглядывать растаивать	снег таять почему солнце
этот конкурс следующий конкурс увидеть принимать участие	этот следующий принимать конкурс участие увидеть конкурс	indx соревнование следующий соревнование заметить3 это 2ps стараться принимать участие
если вы решать участвовать в конкурс быть бы хорошо если бы у вы уже быть готовый проект потому что так легко будет о н м рассказывать доказывать он нужность	быть будет хорошо уже он будет конкурс быть готовый доказывать уча	что любой соревнование принимающий участие желание б-ы проект все готовый легкий принимающий участие проект есть легкий принимающий участие 1ps рассказывать 2ps доказывать легкий
этот организация только для слышать ребенок CODA	этот организация слышать ребенок	indx это организация только <dact> дети2 слышащий кода
но помнить что масло бывать опасный	бывать опасный масло помнить	н-о помнить что если масло бывает это опасный
грубый	грубый	грубый
раз ты просить я подождать	раз просить я поджигать я просить ты	2ps просить 1ps ждать
наш сми за вс в то число и за размещение публикация хотеть получать деньги	получать хотеть размещение число публикация наш весь сми то деньги	у 1ps pl <dact> желание деньги нужда публиковать новости так ведомый деньги
самостоятельно выбирать ответ пожалуйста	выбирать ответ самостоятельно самостоятельно выбирать ответ скорректировать	сам2 нажать отвечать пожалуйста
благодаря сплоченность весь команда они выигрывать	выигрывать сплоченность весь команда они	спасибо команда дружба 3ps pl найти
и слышать и глухой приходить и организовывать свой группа	приходить свой организовывать глухой группа слышать группа	приходить pl слышащий толпа группа pl свой группа глухой
опытный	опытный	опытный
вс весь пока	весь весь	все пока
ждать ваш звонок	ждать ваш звонок	ждать2 ваш звонить.по.видеосвязи
крепкий	крепкий	твердый
например здесь в россия мы открывать свой организация код но мы выбирать русскоязычный название слышать ребенок в семья глухой	название например ребенок организация выбирать русскоязычный слышать наш ребен	пример 1ps здесь россия 1ps создавать2 кода а факт2 clf clf.появиться называть <dact> poss 3ps россия 1ps называть слышащий слышать дети2 семья глухой
еще бывать по-другому при полный блокада дыхательный путь ситуация тяжелый человек не мочь говорить кашлять и дышать т е полный тишина	е еще тяжелый дыхательный кашлять еще е дышать	еще по-другому если полный indx останавливаться это тяжелый человек говорить не.мочь.сделать кашлять2 не мочь дышать не мочь 1ps молчать тихий
я быть сильно тосковать когда ты не становиться	быть сильно я становиться сильно тосковать ты	отвечать 1ps будет очень сильный скучать без вы
ставить лайк и деваться этот видео если оно ты понравиться	видео лайк понравиться ставить деваться оно этот мы	ставить.лайк и делиться это видео если 2ps нравиться
я повезти что проект быть выполнять давно	быть я проект давно выполнять вывозить я	1ps повезло и проект давно был выполнять
кто не видеть это видео в описание будет ссылка на это он и ссылка на плейлист урок остеопатия там вы находить очень много полезный и интересный	полезный плейлист кто очень урок ссылка будет ссылка кто	кто когда2 видеть не видео2 будет indx копировать копировать о писать <dact> это урок <dact> мочь видеть и мочь успех кто интересный множественный очень полезный
нечего дом сидеть с малыш я сам справляться а ты быть прибегать и кормить он	он быть нечего дом прибегать сам справляться кормить сидеть я он	бесплатный прохлада хватит 1ps сам2 ребенок 2ps будет приходить и кормить ребенок
специальность быть весь тот же программирование	тот специальность программаирование быть весь весь быть	п-о специальность то.же.самое направление компьютер
только сам без мой подсказка	сам подсказка мой	н-о сам2 без poss 1ps подсказывать
этот процесс нарастать и человек у который быть килограмм лишний начинать набирать вес ещ быстро словно из воздух	быть начинать лишний процесс этот человек килограмм который воздух нарастать наб	успех у 3ps человек это есть лишний вес пример <nums> к-г лишний успех еще больше pl похоже ничего3 похоже больше pl успех
в нет год быть школа грантовый проектирование да	быть школа проектирование грантовый год давать	<nums> ш школа г проект п проект да indx
у мой брат нет жена	брат мой жена жена	poss 1ps брат жена нет2
начинать учить жестовый язык	начинать язык жестовый начинать начинать язык изучать	начать учить3 жестовый язык
и я непонятно почему вдруг опять чихнуть изо весь сила с какой-то даже подвывание чихнуть вот так апчхи уу	какой-то сила чихнуть я вдруг чихнуть непонятно	1ps новый 1ps зачем не понимать 1ps <dact> <dact>
зима здесь очень холодно особенно в январь начало февраль	начало холодно зима январь особенно очень февраль зима	зима очень заморозить январь февраль срок.между
но получаться так что я глухой я же не смочь быть педагог	глухой получаться быть смочь я я я быть педагог	успех вот 1ps глухой преподавание не.мочь 1ps преподавание
и улучшать углеводный обмен а именно чувствительность рецептор клетка инсулин они снижать аппетит и тяга к сладкий поэтому вечерний капсула рекомендоваться принимать за минута до еда	еда принимать рекомендоваться обмен клетка они терапевтический доза	еще лучше2 <dact> clf clf.организм clf.процесс и чувство <dact> клетка2 <dact> indx ниже еда еще сладкий не.хотеть2 вечер капсула2 советовать з-а <nums> минута до будет еда
мы с вы рано не встречаться	встречаться вы рано мы	мы.вдвоем раньше встречаться был не был
так сейчас	сейчас сейчас	сейчас
там уже быть показываться другой новость	другой быть показываться новость уже	другой новость clf clf.новость clf.подниматься уже
и тогда ваш жизнь обязателньо будет счастливый	жизнь ваш счастливый обязателньо будет	даже poss 2ps жизнь будет обязательный счастье
я не нравиться этот футболка то быть я не быть она покупать	быть покупать она я этот то быть футболка нравиться я	1ps футболка не нравиться тоже покупать не будет
наказывать	наказывать	наказание
следующий одинаковый мировоззрение и восприятие мир	мировоззрение следующий мир восприятие одинаковый мировоззрение	следующий2 мировоззрение восприятие думать мнение pl о мир2 у.всех.одинаково
быть момент когда я нужно быть находить музей и я обращаться к наставник а они находить нужный человек и обменять мы номер	быть обращаться человек я находить я обменять момент нужно музей мы	1ps недоставать 1ps обратиться пожалуйста искать <dact> был 1ps искать нужно это 1ps обратиться пожалуйста <dact> успех 3ps хороший 3ps искать успех и обмен poss 3ps clf clf.сводить clf.людей
а кролик сидеть в мешок переживать вспоминать хороший время как играть с мальчик и общаться с лощадь	мальчик играть общаться вспоминать кролик время стоять мешок переживать хороший	indx <dact> clf clf.куча кролик переживать помнить был хорошо время мальчик беседовать игра indx лошадь был общаться
какой причина	причина какой какой причина	причина какой
привет я звать мир	мир я привет звать	приветствовать 1ps имя <dact>
этот механизм будет работать только если мы взять грамм белок грамм жир из жировой запас и грамм глюкоза из гликоген	грамм грамм работать механизм взять грамм грамм грамм грамм этот	успех <dact> <nums> грамм indx <dact> <dact> и-з <dact> выбирать
и чем	что то	<dact>
у я нет никакой одежда	никакой одежда я я	1ps одежда2 нет3 нет2
здесь пособие не выдавать	выдавать пособие	пособие деньги 1ps помогать 3ps давать 1ps нет2
твердый	твердый	твердый2
мочь быть у вы другой причина я не знать у весь по свой	знать причина другой мочь свой быть весь вы весь я	мочь быть у 2ps pl другой причина indx не.знать2 свой pl
тихий	тихий	тихий
нога муж лечить несколько месяц а потом он вернуться домой к нормальный жизнь	несколько жизнь он нога месяц домой нормальный вернуться лечить муж	indx 1ps исправлять 3ps некоторый месяц а проходить о-н возвращаться домой к обычный жизнь
он постучаться в последний дом и прокричать впускать отдыхать дорожный человек	человек он дорожный последний впускать прокричать постчаться дом посещать отдых	indx последний смотреть стучать2 кричать выпуск дорога2 человек отдых
мы приезжать сюда с цель увидеть храм	приезжать увидеть цель мы храм	1ps приезжать зачем что видеть церковь <dact> дворец
если вы сомневаться нужно или не нужно то хорошо добавлять бальзам ничто страшный не будет	нужно добавлять нужно ничто вы будет сомневаться хорошо хорошо	если вы сомневаться необходимость не.нужно улучшать <dact> добавлять можно страх не иметь
я можно находить в Instagram во вконтакте	можно я вконтакте находить можно	можно находить 1ps instagram indx можно вконтакте 1ps
мокрый	мокрый	мокрый
мы брать разный проект к пример взять один проект и заплатить человек взять второй и третий заплатить тоже	взять взять второй взять взять разный взять второй мы проект запла	проект другой получать pl indx пример indx проект indx зарплата 1ps 3ps человек indx зарплата 1ps 3ps indx зарплата 1ps 3ps
весь что у вы в жизнь происходить будет меняться	жизнь меняться происходить вы весь будет	все что у 2ps pl случай pl жизнь будет изменить
в год весь немного поутихнуть и решать проводить II съезд глухой	решать проводить весь поутихать глухой съезд немного год	<nums> год чуть-чуть успокоить и <nums> год желание проводить второй форум второй форум желание проводить clf clf.люди clf.собираются clf.в clf.одном clf.месте н-о indx <dact> indx
мой друг захотеть перечитывать сказка владимир григорьевич сутеев	сутеев перечитывать переставать григоревич мой владимир захотеть	poss 1ps друг желание читать дизайн <dact> <dact> <dact>
я должный уметь побеждать в война	должный побеждать война я уметь	1ps обязанность качественный стратегия что война победа
там рассматривать мой проект спрашивать чем помогать и помогать я стараться участвовать в любой соревнование в новосибирск и другой город буквально в любой	рассматривать другой город любой участвовать спрашивать любой стараться любой	clf clf.рассматривать clf.проект что нужно 1ps просить перечислять 1ps давать 2ps стараться любой соревнование что здесь новосибирск традиция город некоторый тоже традиция это indx соревнование успех принимающий участие
если месяц назад то на самоизоляция а если месяц или тогда как	самоизоляция назад месяц месяц то какой месяц	<nums> месяц раньше <nums> месяц т-о самоизоляция если месяц <nums> месяц 3 <dact>
когда льдина уже почти растаивать он увидеть в вода деревянный бочка	он растаивать почти увидеть деревянный вода бочка уже льдин	когда быстрый таять clf clf.льдина таять медведь замечать вода indx деревянный бочка clf clf.бочка clf.плывет
например нужно или нет учить характер общение с ребенок	например нужно общение характер учить ребенок	например характер общаться с ребенок необходимость не.нужно
поэтому должный быть отдельный факультет для тот кто хотеть продолжать качественно учиться с переводчик	переводчик отдельный должный продолжать должный учиться тот кто быть факультет	поэтому должен быть отдельный <dact> 3ps кто желание продолжать качественный clf clf.человек clf.приходить переводчик преподавание переводчик indx
семья это счастие любовь и удача	это счастие семья любовь удача	семья это счастье любить счастье удача
видео мы отправлять несколько человек давать он весь посмотреть	отправлять несколько человек он давать весь посмотреть видео мы	видео отправлять.сообщение pl все просить смотреть смотреть2
когда в школа глухой работать переводчик то они согласный приходить	согласный переводчик глухой приходить работать то школа они	школа глухой работать есть переводчик 1ps приходить гап
наш настроение легко портиться из-за политика из-за другой ситуация отношение	наш настроение отношение портиться политика ситуация легко другой наш	мы очень легко грустить влиять 1ps страдать политика другой случай pl
на сегодняшний форум проблема со связь	форум проблема связь сегодняшний	здесь сегодня <dact> проблема2 интернет связь
не столько я себя плохо чувствовать сколько хотеть оставаться дом и никто не видеть	оставаться хотеть плохо чувствовать видеть оставаться я дом себя столько	1ps н-е только2 чувствовать плохо.себя.чувствовать плюс 1ps не хотеть никто видеть
если у вы появляться ещ вопрос писать мы в комментарий под видео	писать вы появляться вопрос видео еще видео мы писать комментарий	или случай ещё есть вопрос писать комментарии
а за остальной деньги куда пойти	остальной деньги пойти	а indx нужно <nums> успех <nums> еще деньги clf clf.много clf clf.деньги куда
понимать нужно делать шаг для это развитие а не то как вы требовать давать и далеко сидеть сложа рука	далеко требовать рука понимать шаг сложа нужно вы делать давать это	шаг pl <dact> необходимость <dact> это развитие понимать 2ps желание требовать <dact>
отставать	отставать	отстать
ваш обычный еда не мочь так как я виноград гилберт	я мой мой виноград обычный еда гилберт мой я	еда обычный простой все4 не мочь это 1ps виноград <dact>
она посмотреть вверх и увидеть красивый голубой небо и облако	голубой облако небо красивый увидеть она посмотреть вверх	clf clf.посмотреть clf.вверх красивый <dact> небо голубой и <dact> clf clf.облако clf.pl
из москва	москва черта	и-з москва
умный	умный	умный
если она не давать то она начинать гавкать	начинать она она давать то гавкать	если давать 3ps 1ps 3ps гавканье
и тот быть тоже быть ехать грязный рука	тот быть ехать рука быть грязный рука быть	еда грязный
белый и зеленый чай зеленый кофе содержать природный кофеин который повышать влияние адреналин на жировой ткань в результат гореть наш жир	влияние чай наш результат который белый повышать содержать чай аргентина	белый2 зеленый <dact> зеленый <dact> составлять природа давать <dact> это давать энергия увеличение <dact> <dact> ткань получаться poss 2ps <dact> огонь
можно еще кондиционер в вид пена он легкий сглаживать волос и придавать легкий увлажнение	он кондиционер легкий можно еще вид увлажнение сглаживать придавать легк	можно <dact> <dact> пена легко clf clf.сглаживать clf clf.волосы легко увлажнение
опыт помогать я чувствовать себя уверенный в себя	себя чувствовать помогать опыт себя уверенный я чувствовать опыт	indx 1ps чувствовать себя уверенный
ну да давать премия вс правильно	давать премия давать правильно весь правильно	премия 3ps давать 1ps
терпимость это то что сегодня так не хватать	хватать сегодня это то терпимость	терпимость это сегодня нужно pl
май самый т плый весенний месяц	весенний самый месяц т плый май май	<dact> всегда теплота в.течение весна теплота
всего-навсего студент	все все студент все-насилье	маловажный хз2 студент2
в полдень студент распахнуть окно и выглядывать в сад	полдень студент окно сад расхватывать выглядывать	день <nums> день студент2 открытый окно открытый видеть
осень ребенок надевать штаны сапог куртка и брать зонтик	куртка осень штат зонтик брать надевать мати носить осень сап	осень дети одеться брюки сапоги куртка зонт <dact>
луиза очень привязываться к девочка но удерживать она не мочь не иметь право	право мочь она привязываться луиза очень девочка иметь удерживать	<dact> учить сильный любить девочка н-о держать не мочь нет3 право
антон пылесосить ковер и выкидывать мусор а дедушка например помогать бабушка и заниматься внук учить антон играть в шахматы а катя читать е любимый сказка	например антон шахматы читать каня мать е антон	<dact> пылесосить плоский <dact> выкидывать пример дедушка 1ps помогать 3ps бабушка2 заниматься <dact> если трудно обучать2 <dact> обучать2 шахматы <dact> читать любить сказка
двигаться в правильный направление в пищевод это называться пищевой желоб	двигаться направление называться пищевой пищевой двигаться это правильный желоба	clf clf.двигаться направление правильный еда жевать2 внутренний <dact> назвать еда <dact>
хотеть немного подробно вы рассказывать чтобы кто-то быть полезный	быть полезный рассказывать вы хотеть немного подробно кто-то	немного желание подробный рассказывать открытый изучать все быть полезный
я уметь красиво писать	красиво писать я уметь	1ps красивый написать мочь2
на поляна нет гриб	полена гриб лимон	территория гриб нет2
разрушать	разрушать	разрушение2
однако встречаться различный проблема и непонятно как двигаться далеко	различный двигаться непонятно встречаться проблема далеко	дальше тупик pl как
если сдерживаться невозможно у вы быть пара минута чтобы добегать до туалет и расслабляться	невозможно расшифровываться вы добегать минута туалет пара сдерживаться быть	сжатый не.мочь clf clf.чуть минута.две минута.три давать что до туалет бег2 место все4
но ты спас я жизнь	спасать жизнь я жизнь мы	н-о 2ps спасать poss 1ps жизнь
тот же фамилия и у бабушка с дедушка ведь она переходить папа от они	она тот они фамилия тот они бабушка переходить дедушка папа папа	одинаковый фамилия бабушка2 дедушка poss 3ps родители папа потому что папа передать 3ps передать 1ps фамилия свой родители
я тоже хотеть носить красивый платье	хотеть платье я носить красивый	1ps тоже желание носить платье красивый
поэтому запасаться полезный продукт и поехать	запасаться продукт полезный поехать	это собирать2 подготовка собирать2 и начинать
ну весь золушка теперь ты мочь ехать во дворец	дворец мой весь ехать теперь золушка ехать мочь	все сейчас <dact> 2ps мочь уезжать дворец
очень мало человек заниматься программирование	человек заниматься программирование мало очень	программирование дефицит <nums> человек все2
также плохой труба и канализация где протекать плохой вода и из кран так же бежать плохой и ржавый вода	вода плохой вода река также вода протекать плохой плохой канализаци	это плохой вода труба <dact> clf clf.течь clf.из clf.крана грязный ржавчина труба pl плохой <dact>
я нравиться общаться с людьмиб интересно узнавать что случаться	я знакомиться узнавать человекьмиб случаться интересно общаться нравиться хорошо	1ps pl нравиться общаться человек интересный узнать случай что
весь время они играть и гулять вместе как друг мальчик заболевать	гулять друг весь время играть вместе заболевать мальчик они другой	вместе pl игра гулять разнообразный вместе pl вдруг 2ps мальчик болезнь
бывать что катя и антон ссориться но потом обязательно мириться	бывать обязательно мириться катя антон смиряться сорваться	<dact> <dact> быть pl ссориться быть pl н-о потом обязанность мириться
когда человек начинать кашлять хвататься за горло что мы должный сделать как должный помогать	должный должный человек мы должный сделать должный хвататься начинать горло	человек начать кашлять2 задыхаться2 кашлять2 что мы должен 1ps помогать 3ps какой должен был
этот чай работать как антиоксидант бороться с некоторый процесс в организм	чай этот бороться процесс некоторый работать организм алюминит	<dact> indx работать2 как <dact> как против организм что есть
он слушать когда говорить и понимать	понимать говорить слушать он	3ps слушать говорить2 indx понятый
главное чтобы он действительно представлять то как бы он хотеть чтобы быть	действительно главное представлять быть он хотеть то он	главный 3ps должен представить3 <dact> 3ps желание что был
второй совсем не принимать	совсем второй принимать совсем	следующий3 второй совсем взять не
они часто приходить на берег и плавать прыгать в вода	приходить вода плавать часто пригать берег они пригать пригать часто	двое часто приходить clf clf.берег плавание clf clf.с clf.берега clf.прыгать clf.в clf.воду
я любить красный помада	любить красный я плада	губная помада 1ps любить красный
я не хотеть выступать на концерт	хотеть выступать я концерт	концерт сцена принимающий участие не.хотеть
без вы у я на сердце тоска	сердце вы я тока вы	без 2ps сердце чувствовать грусть
желчь	желчь	<dact>
давать разбираться зачем мы есть	разбираться давать мы быть	пробовать исследовать почему мы еда почему
привет друг я звать андрей	друг андрей звать я привет	привет друг pl 1ps имя а-й
каков причина этот проблема у глухой	каков причина глухой проблема этот каков	проблема2 глухой indx причина какой
старуха удивляться	старушка удивляться	удивление старый
достоинстно	достоинстно	гордость
сейчас я заниматься инскусственный интеллект т е то как он распознавать жестовый язык и переводить он в текст такой вот у я тема	такой текст он я я т он я жестовый язык распознавать	indx тема2 какой это <dact> какой это <dact> <dact> это для2 poss 3ps <dact> говорить на жестовом языке 3ps воспринимать 1ps говорить на жестовом языке 3ps воспринимать 1ps переключаться написать использовать искусственный.интеллект внутри тема2
переходить к тема	тема переходить	clf clf.отодвинуть тема2
счастливый	счастливый	счастливый
каков причина	причина каков	причина2 pl какой
пожалуйста научать жестовый язык	язык жестовый научать надо	пожалуйста <nums> учить3 1ps мочь2 школа пожалуйста жестовый язык
и на розовый куст на самый верхний побег начало распускаться великолепный роза	начало самый распускаться верхний куст розовый побег вполне распуска	кусты розовый цветок кусты clf clf.побег clf.растения начинать clf clf.распускается clf.цветок красивый шикарный цветок
если быть учитель наставник то продвижение быстрый будет потому что ты учить и сопровождать да	будет будет продвижение быстрый сопровождать учитель быть то давать	быстрый будет карьера indx опыт есть 3ps учить 1ps 1ps заместитель да
вопрос такой вы уже переболеть	переболеть вы вопрос такой уже	вопрос 3ps 1ps заболеть уже
если бы я не становиться переводчик я заниматься бы продажа быть бы экономист	быть переводчик экономист заниматься я становиться я продажа я	если 1ps переводчик нет2 б-ы был продажа экономика2
аплодисменты	абоодисменты	аплодисменты
бывать низко температура	бывать температура низко	ниже быть <nums> ниже
главное смотреть на то как выглядеть волос и что вы нужно на каждый день	то главное выглядеть нужно каждый день смотреть вы	главный вы смотреть чувствовать clf clf.волосы clf.тяжелые что вы необходимость каждый день
далеко договариваться с государство а оно просить взятка	государство взятка договариваться оно далеко просить	следующий пример государство 1ps pl договор государство беседовать взятка
как пить капсула фуд контрол	контроль капсула пить гель фуд	как таблетка <dact> <dact> как
при пережевывание еда распадаться на кусочек чтобы организм быть легко нужный слюна она смешиваться с еда и расщеплять она	она она еда быть нужный она распадаться смешиваться кусочка е	когда2 жевать2 еда clf clf.распадаться clf.кусок что организм легко2 нужно <dact> clf clf.смаковать еда жевать2 исчезать
весь крепко и крепко прижиматься соловей к шип и песня он звучать весь громко и громко ибо он петь о зарождение страсть в душа мужчина и девушка	песня прижиматься весь душа слышать он шип страсть в	птица2 clf clf.прижиматься clf.телом clf.к clf.шипу песня кричать птица2 это о-н песня о появляться эмоция все включено мужчина2 и девочка
я хотеть выступать на концерт	хотеть выступать я концерт	1ps желание принимающий участие концерт
почему выбирать это число	выбирать число это	число выбрать почему
в концертный зал кто-то быть	зал быть кто-то концертный	концерт зал <dact> кто есть indx
лето расти вкусный яблоко	яблоко лето расти вкусный расти	лето расти вкусный яблоко clf clf.есть clf.яблоки
вот значит ствол дерево это возникать проблема нужно узнавать каков е причина и какой оказываться последствие	какой последствие возникать е узнавать дерево значит какой оказыва	indx indx дерево clf clf.ствол clf.дерева indx проблема2 indx причина <nums> что какой pl indx результат итог
они предлагать такой рабочий место куда человек с инвалидность не мочь устраиваться	место такой устраиваться мочь рабочий инвалидность предлагать человек они	3ps предлагать такой работа место куда инвалид вступить просто не.мочь
они уничтожать танк противник с то чтобы обеспечивать дальнейший продвижение пехота	обеспечивать противник уничтожать пехота продвижение танк дальнейший они то	танк уничтовать что clf clf.люди двигаться
мой мама ой мой папа закаляться не знать каждый день чтобы не заболевать обливаться хлодный вода ну знать стоять под холодный душ	каждый день стоять душа знать обливаться вода хлодный знать мой	poss1 мама poss1 папа <dact> не знать каждый день что болезнь нет clf clf.обиваться холодно не знать душ
пока	плохой	прощаться
трудный	трудный	трудный
я часто слушать история на ваш канал и теперь решать поделиться свой	решать свой канал история слушать часто поделиться я теперь ваш	часто слушать история poss 2ps программа и решать разделение 1ps делиться 3ps собственный
в итог никакой поступление энергия нет	поступление энергия никакой итог итог	и ждать2 электричество тратить успех тоже нет2 запас
рубль нет даайт посмотреть что туда входить	рубль даайт входить посмотреть входить	<nums> рубль не <nums> рубль нейтр.имп смотреть входить.во.что-то что
я тоже понимать что уже не мочь без он	понимать он мочь я уже я	1ps сам2 думать что без 3ps 1ps не мочь
поэтому она открывать страница в Instagram о рыжий кот где рассказывать история о бобо который недавно выходить на пенсия	открывать рассказывать она недавно выходить бобо она который страница история рыж	поэтому рыжий кошка3 <dact> открывать instagram2 страница рассказывать история <dact> 3ps совсем недавно уже выходить пенсия
если не получаться то во время реанимация инородный тело оно пройти в один из бронх и тогда один из легкий смочь дышать дыхание будет частичный не в полный объем	будет один тело дыхание смочь реанимация полный один легкий про	если получаться нет т-о в-о время реанимация может.быть поперхнуться бронхи <dact> clf clf.инородное clf.тело clf.сдвинуться удача <nums> легкое удача пустой будет дышать н-е полный н-о часть будет
крепко прижиматься ко я милый соловушка не то день прийти рано чем заалеть роза	приходить соловушка милый прижиматься рано я роза день приходить	clf clf.тело дорогой птица2 если день начинать заранее красный изменять не.успевать
он не уметь кататься на лыжа	он кататься лыжа уметь	о-н мальчик 3ps не мочь не знать кататься.на.лыжах
и вот мы сыграть свадьба и я переезжать к он у они быть три комната в квартира	квартира мы они сыграть я три переезжать свадьба он бы	вместе свадьба 1ps переезд у 3ps indx все включено квартира у 3ps был <nums> комната pl clf clf.комнаты
мочь быть будет кто-то с кохлеарный имлант	кохлеарный мочь быть имлант кто-то будет кто	может быть кто есть к-и кохлеарный.имплант
обязательно быть ошибка а расчет примерный	ошибка примерный расчет быть обязательно	должен ошибка pl clf clf.уровень clf.разный примерно сравнить пример рассказывать
раздражать этот бесконечный ветер	бесконечный ветер этот раздражать	раздражать всегда ветер раздражать
чтобы не заболевать я делать зарядка	делать я заболевать зарядка	что болезнь нет 1ps делать зарядка2
кролик обращаться а я рано не быть настоящий	кролик быть я обращаться рано настоящий я обращаться	кролик обратиться indx раньше2 не.был настоящий не.был
лето можно играть в песочница лепить кулич из песок	песочный играть песок играть можно лето лента песочки песочка	лето мочь игра песок делать пирожок pl делать песок
я самый трусливый и самый слабый из весь животное	самый самый слабый самый животное я трусливый весь	1ps самый3 трус и самый3 слабый2 и-з животное pl
главный задача угвеод обеспечивать мы быстрый энергия во-первых белок и жир организм усваивать в определенный количество а угвеода приниматься в любой количество	обеспечивать приниматься усваивать белый количество азот главный любой количеств	<dact> это 3ps давать 1ps быстрый электричество почему пример <dact> <dact> это внутри.себя воспринимать точно сколько 1ps нужно лишний не.нужно воспринимать а <dact> все любой получать pl воспринимать
он ездить на автобус	он автобус ездить	о-н ехать.на.транспорте автобус автобус
если у вы волос торчать то и вы хотеть они сглаживать то нужно использовать коллаген шелк кератин и белок	хотеть использовать то они шелк кенет использовать хотеть вы хот	если у 2ps pl волосы clf clf.волосы clf.торчат clf clf.волосы clf.торчат желание clf clf.сглаживать что что необходимость использовать <dact> <dact> <dact> <dact>
живот сообщать мозг и он понимать ой да да да где здесь туалет	мозг сообщать он понимать живот туалет ой	живот indx сообщение 1ps мозг возникать понимать да pl тулет искать
тема будет очень интересный о переводчик какой он должный быть какой качество должный обладать и т д	какой интересный переводчик очень какой качество обладать должный будет	тема2 интересный о человек2 переводчик какой должен был какой качественный какой правила2 что пример список2 исследовать будет
потому что когда вы начинать делать что-то в ущерб себя вы начинать ненавидеть тот для кто это делать	кто делать вы себя делать вы начинать тот начинать делать кто	например 1ps себе заставлять3 pl похоже 1ps начинать человек pl ненавидеть2
он встряхиваться отчего мышонок упасть на земля	отчим мышонок упасть он земля встряхиваться	трястись2 мышь2 падать2 н-а земля
и давать направление действительно нужно развивать	направление развивать давать действительно нужно направление развивать	и это направление действительно нужно развивать
я премия не давать	давать премия я	премия давать 1ps не был
чуть в легкий не попадать	легкий чуть попадать	indx clf clf.чуть легкие попал clf clf.чуть
вот например весь знать проблема глухой работа и т д	работа глухой работа знать например весь джим проблема т например	1ps пример проблема2 глухой все самый знать проблема2 работать перечислять2
нужно делать шаг	нужно шаг делать делать	необходимость шаг pl
сжимание стенка называться перистальтика	называться перистальтика сжимание стена стена	clf clf.стенки clf.пищевода clf.сжиматься назвать <dact>
а человек заложник потом отпускать	заложник отпускать человек	брать.за.руку уводить да
сразу невозможно быть получать	получать невозможно быть сразу невозможно сразу	indx <nums> любой толпа получать не.мочь.сделать
в трудовой ресурс зарплата такой же как в материальный	материальный ресурс такой трудовой зарплата	зарплата труд тоже indx мочь ждать
мой брат не любить шоколад с то момент как отравляться он	отравляться любить момент мой брат он то мой отравляться то масло	когда2 3ps poss <nums> брат яд шоколад после2 это не.любить шоколад
я весь этот три день участвовать рассказывать защищать свой проект сказать что у я уже быть письмо поддержка например от музей балл быстро подсчитывать и это быть успех	защищать например быть я я например этот свой весь	день <nums> это indx 1ps делать 1ps рассказывать 2ps защищать 3ps финал защищать 1ps рассказывать 2ps что 1ps indx <dact> есть 3ps поддерживать 1ps печать indx спонсор все есть известный быстрый <dact> и 1ps успех
смотреть группа из человек это мало человек это много	это мало человек человек много это группа смотреть группа много человек это	смотреть indx <nums> человек группа <nums> человек мало <nums> человек множество толпа
урок называться наш дружный семья	наш дружный называться урок семья	урок назвать poss 1ps pl дружба семья
кто там в новосибирск быть	новосибирск быть кто кто	кто indx indx новосибирск есть
а проблема то в то что мы мочь говорить на жестовый один рука а в англия человек так не мочь	говорить один мочь человек жестовый то мочь проблема то рука англия мы	indx проблема2 indx англия жест только2 fs clf clf.использовать clf.обе clf.руки два говорить на жестовом языке рука один говорить на жестовом языке мочь2 телефон говорить на жестовом языке мочь2 англия нет3
ну если ничто нет давать варить каша из топор	каша ничто топор давать варить	н-у если ничего нет2 нейтр.имп. пробовать готовить <dact> и-з топор2
первый раз укусить начинать жевать	начинать начинать раз первый жевать раз усить	когда2 первый clf clf.укусить начать жевать2
температура то повышаться то понижаться снег мочь то неделя лежать а мочь мало и потом растаивать	повышаться то лежать растаивать температура то повышаться мало неделя мо	температура повышать быть понижать clf clf.толстый clf.слой <dact> <nums> неделя мочь меньше таять
главный дед мороз удивленно посмотреть на он и сказать теперь ты быть не маленький дед мороз а лесной	маленький теперь главный дед он посмотреть теперь быть дед мороз	дед.мороз видеть главный видеть удивление дать был <dact> дед.мороз поменять <dact> что лес точно
медвежонок ларсить жить на северный полюс вместе с мама и папа	медвежонок северный жить вместе ларшать папа папа полюс мать	медведь имя <dact> жизнь место clf clf.шар indx северный вместе родители
в это дом не бывать гость	бывать гость дом это	это дом гость ноль
ошибка считать что можно похудеть быть принимать капсула лежать на диван и ходить по тысяча шаг в день каждый день увеличивать это количество на шаг	можно каждый лежать принимать тысяча день лежать можно	все думать лекарство лежать лекарство уже <nums> тысяч <dact> ходить нужно каждый день увеличивать <nums> ходить увеличивать
пожалуйста выбирать то кто по ваш мнение входить в сообщество глухой	выбирать сообщество входить глухой мнение то кто выбирать ваш входить	пожалуйста выбрать pl поставить.галочку выбрать poss 2ps мнение что включать мир2 глухой
весь спрашивать почему на юг так популярный одежда защищать от ветер	популярный одежда весь юг спрашивать ветер защищать	все спрашивать 1ps ю-г популярный clf clf.толстая clf.одежда защита ветер
я в близкий время хотеть сделать опрос о то кто желать становиться глухой экскурсовод экскурсовод для глухой	хотеть опрос близкий кто я глухой то сделать хотеть экскурсо	1ps будет опрос 3ps pl кто желание переводчик глухой <dact> проводить кто желание есть желание
проходить день неделя а она весь мечтать	она неделя проходить весь деньмечтаать	желание проходить день проходить неделя
ясный	ясный	яркий солнце светлый
да он мастер форма это у он отнимать нельзя но быть ли у он чувство	он он нельзя быть он чувство это форма отнимать мастер	да 3ps мастер песня голос2 качественный н-о интересный у 3ps чувствовать общий есть нет2
у они бюджет быть от сто двести тысяча и высоко	тысяча быть они высоко двести сто бюджет	3ps финансирование2 о-т <nums> тысяча pl и выше
в инкубатор быть свой плюс ты давать помещение оказывать финансовый и юридический помощь оборудование техника много что давать	техника оказывать юридический оказывать свой помощь давать быть	это <dact> попадать indx <dact> плюс pl что 3ps давать 2ps комната2 мочь 3ps давать 2ps бухгалтерия юрист помощь множественный что 1ps давать 2ps мочь механизм компьютер
ладно сам доносить	сам доносить далеко	пусть сам2 clf clf.нести clf.на clf.плече
маша не спать весь ночь она готовиться к экзамен	ночь экзамен спать готовиться маша она весь	<dact> н-е спать не все нет с утра до вечера ночь 3ps подготовка экзамен
в магазин быть сыр	быть магазин сырой	магазин <dact> магазин есть
очень много глухой готовый заниматься л гкие дело	гкий глухой очень много заниматься дело л готовый	человек много человек pl так будет делать хуже дело
но с ветер конечно по-другому	конечно ветер по-другому	ветер случай другой будет
гаснуть	гаснуть	clf clf.свет clf.выключить
энергия давать позитивный мышление и жизненный тонус	жизненный жизненный энергия давать позитивный мышление тонус	энергия давать 1ps мысль плюс pl и жизнь возбуждение
но это мой жизнь	жизнь мой это	это 1ps жизнь
если я король то ты очень храбрый принц это лес	король очень я принц это очень лес мой храбрый то	если 1ps король т-о 2ps очень смелый <dact> лес2
эхо понести этот трель к свой багряный пещера в гора и разбудить спать там пастух	свой гора пещера плавать этот свой плавать понести пятеро спа	приветствовать clf clf.эхо clf.распространяется гора clf clf.эхо clf.распространяется звук clf clf.эхо clf.распространяется кто пастух indx спать слышать просыпаться
в результат слышать ребенок не давать жестовый язык	результат жестовый ребенок язык давать слышать	какой это н-е давать нет слышащий дети2 жестовый.язык
как это из топор можно сваривать каша	это топор сваривать каша можно	как <dact> и-з топор2 мочь готовить вопрос
животное встречаться влюбляться с первый взгляд подружиться и помогать друг друг выздоравливать	друг друг влюбляться помогать встречаться выдоравливать животное друг взгляд перв	такой встреча <nums> 3ps 3ps животное2 <dact> влюбиться первый взгляд.друг.на.друга дружба друг.друга помогать 3ps 1ps pl здоровый
быть тот кто смотреть и говорить ну это же так просто и легко не смотреть	говорить легко кто тот смотреть быть смотреть это	мочь кто смотреть н-у простой легко2 все4 поэтому кто смотреть не.нужно
нечестный	нечестный	честный нет
рано он называться иср а сейчас название новый истый	он название иср новый называться сейчас рано истый дыра	раньше был <dact> сейчас3 новый <dact>
фрукт уже практически нет	фрукт практически уже	плод pl мало уже
весь ребенок начинать изучать жестовый язык	начинать изучать жестовый язык ребенок весь весь	ребенок уже начать задавать.вопросы жестовый язык
вдалеке увидеть деревня	вдалеку увидеть деревня	смотреть деревня далеко3
сам смотреть что вы надо что не надо	надо сам надо смотреть вы хорошо надо	сам2 смотреть как нужно что poss 2ps pl что не.нужно
и он высовываться из окно и сорвать она	срывать высовываться он она окно	студент2 clf clf.высовывать clf.голову clf.из clf.окна окно clf clf.высовываться clf.из clf.окна срывать clf clf.держать clf.цветок clf.в clf.руке
она быть такой же злой и вредный	вредный она такой быть злой	характер такой.же злость вред
вы так беседовать со свой ребенок	свой ребенок беседовать вы вы	тоже 2ps pl беседовать собственность дети2
делать нужно в определенный модификация	нужно определенный модификация делать	н-о только2 делать в странный мода
следующий человек потерять слух во взрослый возраст	следующий возраст слух потерять человек взрослый	следующий2 человек pl кто оглохнуть взрослый
например первый это грант	первый это например грант	пример первый <dact>
мальчик ловить и крупный рыба	мальчик крупный рыба ловить ловить	мальчик ловить великий рыба2
первый это хлопок по спина	первый это первый группа мальчик это справка	первый 1ps нужно спина clf clf.человек clf.выбить clf.инородное clf.тело
как сделать я	сделать я я	как делать 1ps
работа в команда похожий на профессиональный спорт	похожий профессиональный работа команда спортсмен спорт	indx и почему 1ps говорить объяснять команда indx такой профессионал спорт
здравствовать	здравствовать	здравствуйте
на этот земля не расти ни кукуруза ни картошка	кукуруза расти этот земля картошка	земля территория расти <dact> картофель расти не мочь
что мы нужно сделать	нужно мы сделать	что мы нужно делать
я быть делиться свой опыт	свой быть делиться опыт я делиться	1ps свой опыт будет 1ps делить советовать рассказ кто 3ps pl жестовый.язык
друг	другой	друг
а у старушка весь быть	старушка быть весь весь	3ps у 3ps старый все есть
наслаждение	возражение	наслаждаться
я любить сосиска	любить я сосиск	1ps сосиски 1ps любить
ветер здесь до м с	ветер м м	ветер до <nums> м секунда
нужно изменять себя внутри переставать заставлять себя и жертвовать себя	себя заставлять себя нужно изменять себя заставлять переставать себя	нужно внутри.себя изменять себе заставлять3 нет2 отдавать.себя нет2
необходимо привозить оборудование который предоставлять электричество	необходимо предоставлять который привозить оборудование электричество	необходимость собственность clf clf.взять clf.привезти оборудование электричество деньги clf clf.взять clf.привезти необходимость доставка
ругать	ругать	ругать2
падать снег и быть темно	падать снег быть темноснежный	идет снег был ночь
грубый	грубый	грубый
слышать всегда смотреть на то какой вы команда если сильный вы быть работать	вы слышать какой вы то сильный работать команда быть смотреть вы	слышащий 3ps pl видеть команда какой 3ps команда сильный будет делать
получаться столбец не связанный слабо связанный средне связанный сильно связанный	связанный связанный связанный связанный столбец связанный связанный связанный получаться	получать2 clf 4.столбца первый здесь связать пустой так.себе связать норма нет2 столбец связать есть н-о так.себе слабый связать есть средний связать крепкий
попадать	попадать	попасть clf clf.что
я начинать этот занимать в год и обучение там длиться день с утро до самый вечер	начинать обучение день самый длиться этот утро занимать год вечер я	1ps начинать был <nums> indx день <nums> учиться с утра до вечера учиться
и он вернуться к себя в комната вытаскивать большой запылить книга и приниматься она читать	вернуться она книга большой приниматься засыпать себя вытаскивать	студент2 обратимый домой комната собственный книга clf clf.книга clf.большая clf.тяжелая протирать <dact> протирать и clf clf.открыть clf.книгу начинать взглянуть читать
отношение быть меняться	отношение меняться быть	отношения изменять будет
можно ли в ваш регион подписывать соглашен о трудоустройство человек с инвалидность в другой организация	подписывать другой регион организация можно трудоустройство инвалидность человек соглашать ваш	можно л-и poss 2ps регион подпись <dact> о трудоустройство инвалид другой организация
он никогда не быть в турция	он турция быть	3ps никогда2 турция не был
или если у вы быть знакомый который знать финский жестовый язык передавать он этот информация пожалуйста	знать жестовый быть знать вы он информация этот финский язык передавать знаком	или у есть знакомый 3ps знать жестовый.язык2 финляндия 2ps передавать пост2 видеть отправлять пожалуйста
подымать	подымать	clf clf.поднимать
я видеть что вокруг много молодой человек школьник который не думать куда поступать а думать куда пойти они друг или куда направлять они родитель	поступать друг друг они думать школьник человек молодой родитель направлять	так 1ps замечать вокруг много молодой и школа думать 1ps куда поступать брать.пример.с друг родители 3ps заставлять2 1ps
у третьяков быть хобби он быть меценат и оплачивать строительство школа для глухой ребенок выделять целый тысяча на это и в год построить трехэтажный здание школа	быть хобби построить тысяча школа триэтажный школа третьяков целое	и <dact> 3ps <nums> дело хобби 3ps деньги финансирование забота семья школа для глухой <nums> тысяч отправить з-а строить clf clf.здание строить <nums> год этаж <nums> здание
тамара долго идти по почти непролазный дорога и вдруг увидеть дым из труба один из дом она обрадоваться побежать подавать и весь грязный добираться наконец до это дом	грязный она почти вдруг идти дым увидеть подавать дом дорога	ходить медленно место дорога был неприятный стремный н-о глаз indx дом дым и видеть бежать2 падать2 плакать тело грязь добраться до это indx дом
мы радоваться когда гладить котенок и чужой слово влиять на наш настроение	наш влиять наш наш радоваться чужой настроение мы гладить котенок слово	когда2 мы радоваться радоваться что видеть например кот indx что гладить2 слово чужой сказать 1ps влиять 1ps настроение
хм а кто же будет кучер	кто будет крюк хм кто кто хм кереметать	задуматься кто 3ps будет кучер
там быть мой кворки нажимать создавать кворк	создавать быть мой кворк кротка нажимать квота	indx <dact> <dact> indx строка создать <dact>
смотреть как он обучать что нужно добавлять	добавлять нужно он смотреть обучать	<dact> clf clf.человек обучать2 что необходимость добавить
мой отец бояться мачеха	бойяться мой отец бойяться майхамет	poss 1ps папа мама второй бояться3 бояться
к сожаление фотография прабабушка и прадедушка родитель бабушка и дедушка не сохраняться поэтому на это дерево весь начинаться с бабушка и дедушка	дерево бабушка бабушка бабушка бабушка бабушка начинаться сохраняться сожаление	сожаление фотокамера <dact> дедушка <dact> бабушка2 отсутствие 3ps родители 3ps бабушка2 дедушка отсутствие сохранять отсутствие поэтому indx дерево все начать бабушка2 и дедушка
ну в общий это вс что я хотеть сказать	хотеть общий сказать весь я это сказать	все результат 1ps желание сказать
это желание будет помогать копить	помогать копить желание это будет	это желание 1ps помогать 1ps копить будет
ленивый	ленивый	ленивый2
муравьед любить кушать насекомое авокадо цитрусовый	муравьед любить авокадо цитрусовый кушать насекомое переста	3ps еда <dact>- паук <dact> апельсин <dact> еда обожать2
зато рейтинг высокий и много заказ а у он все заказ быть отзыв	заказ весь заказ высокий быть он много заказ рейтинг застраховывать	3ps высший р-е- заказ pl много у 3ps <nums> 3ps заказ быть pl <dact>
когда у маленький дед мороз весь подарок быть готовый остальной вс думать что снова надо будет ехать дарить ребенок подарок возвращаться домой что это очень скучно	ехать дарить надо очень возвращаться остальной будет снова маленьк	3ps подарок похоже готово clf clf.коробки clf.расставить готово это ждать все дед.мороз неинтересно опять2 не.хотеть ехать.поездом дети подарок pl назад домой не.хотеть похоже неинтересно поэтому думать обсудить пусть
еще раз хотеть сказать что каждый момент свой жизнь нужно наполнять радость	каждый жизнь свой нужно раз хотеть радость сказать момент наполнять	еще раз хотеть сказать каждый момент свой жизнь нужно наполнять радость
костик и мишка сказать тоже где ты быть что с ты приключаться рассказывать	рассказывать костика ти мишка ти быть рассказывать костика сказать мы рассказывать	еще <dact> <dact> 3ps спрашивать 1ps тоже где был случай что 2ps рассказывать 1ps
семен по путь с работа забирать дочка из садик и к ужин они всегда быть дом но не в этот злосчастный день	дом день этот работа они семя быть ужин день злосчастный садик	<dact> работать clf clf.человек clf.идет 1ps забирать 3ps дочь и-з дети <dact> и вечер всегда2 домой еда стол н-о попадать день беда
и по свисток начинать собирать человек на съезд в москва начинаться беготня в общий постанавливать собирать человек в москва в июль год	начинать общий человек собирать человек собирать общий москва москва начина	и свистеть начинать clf clf.люди clf.собираются clf.в clf.одном clf.месте съезд москва попал беготня общий постановить clf clf.люди clf.приходят москва <dact> <nums> год2 <dact> clf clf.люди clf.приходят
как жираф	жирфь	жираф похоже
смотреть результат быть	результат быть смотреть	смотреть иметь результат
краудфандинг	краудфень	<dact>
когда вы себя насиловать унижать у вы нет уважение к себя вы не в состояние что-то давать	вы себя что-то насиловать вы себя состояние унижать вы уважение да	похоже отдавать.себя себе унижение себе уважать 1ps нет2 похоже 1ps не мочь давать pl
однажды они зайти в лесной глушь	зайти лесной они глушь однажды одинокий	вдруг лес внутри
мама он сразу начало учить я жизнь что я должный муж беспрекословно во весь слушаться и сразу выполнять весь что он требовать	слушаться он я он весь должный я весь сразу начинать	мама poss 3ps начинать 3ps учить2 1ps <dact> жизнь что 1ps муж должен был послушный2 3ps заказывать 1ps 3ps приказать 1ps 3ps требовать 1ps 1ps выполнить
я работать уже давно с начало создание адаптиса	начало работать создание давно я адаптис уже давно	1ps стаж2 давно все4 работать2 когда начинать создавать2 sn
без знание жестовый язык этот ребенок не являться CODA	жестовый язык ребенок являться этот знание	жестовый.язык не.знать считать2 н-е кода нет 3ps
нордис в г новосибирск	нордис новосибирск г	<dact> новосибирск здесь
благодаря плодоножка вишня в организм не накапливаться лишний жидкость а в жировой ткань активизироваться процесс микроциркуляция	лишний процесс микроцирковка организм плодоножка накапливаться жидкость ткан	еще clf clf.плодоножка indx indx н-е 3ps давать 1ps добавлять жидкий лишний внутри.себя и активный промежуток.времени управлять <dact> внутри.себя ткань
они поехать в приют и предлагать вместе с они собака пойти на долгий прогулка	приют прогулка долгий предлагать собака поехать они вместе по	<dact> поехать место <dact> и нейтр.имп вместе собака poss 3ps забирать и гулять долго
я вс учитывать и тогда я получать удовольствие от работа потому что она быть в кайф	работа получать она весь удовольствие я быть я учитывать кайф	1ps все считать2 и 3ps pl удовольствие 1ps работать почему indx кайф3
вообще весь человек журналист ленивый	журналист вообще человек ленвый весь уже	все журналист все человек pl ленивый все
я удаваться оформлять кредит благодаря то что в банк к мой проблема относиться с понимание	кредит то банк проблема оформлять удаваться мой понимание относиться я	1ps мочь2 оформлять кредит почему благодаря понимать 1ps есть проблема2
готовый	готовый	готовый
потом няня становиться жалко кролик но доктор сказать надо сжигать и давать новый	надо сжигать жалко кролик становиться доктор давать новый сказать ня	потом 2ps няня2 смотреть жаль врач2 спрашивать доктор2 indx кролик indx так огонь новый давать
но вы сам понимать что связь у я не так много но то не менее шанс уже быть у вы быть шанс получать помощь	вы помощь шанс я быть то шанс понимать менее получать связ	н-о у 1ps понимать2 зависеть мало временный есть 2ps pl <dact> есть радость 2ps спрашивать 1ps
и плюс всегда развиваться учиться идти вперед	развиваться идти вперед учиться плюс	и плюс всегда развитие учиться идти.вперед
и если милиция я не находить	милиция находить я я	вдруг indx милиция 1ps 1ps искать 3ps успех нет
спонсор готовый платить я выполнять проект в это город нехватать мыло я сообщать спонсор получать мыло и раздавать	получать город это мыло спонсор нехватка мыло я получать раздавать	платить2 согласие постоянный платить2 1ps проект выполнять сдать pl город indx не.хватать 1ps объявлять 3ps clf clf.взять clf.мыло сдать pl
сейчас глухой начинать активно заниматься индивидуальный предпринимательство и это плюс потому что они становиться независимый	глухой начинать независимый предпринимательство активно индивидуальный заниматься это они станов	все и-п мочь indx плюс потому что свой зависимость не
они наблюдать и чувствовать что необходимо создавать общество для ребенок CODA	общество необходимо ребенок наблюдать создавать чувствовать они	смотреть pl чувствовать что нужно создавать2 общество группа для кода
либо где можно находить спонсор чтобы получаться сокращать количество деньги и расход быть по ноль	можно быть деньги получаться либо сокращать количество спонсор расход но	или где можно находить спонсор что составлять получаться деньги кратко расходы ничего
кто-то печ т торт кто-то фотографировать работать в такси и развивать автопарк кто-то заниматься ремонт	кто-то ремонт кто-то кто-то ремонт кто-то	кто торт печь кто фотография2 достигать кто такси подготовка автомобиль <dact> развитие кто ремонт
я очень рад что быть выбор профессия специальность	быть очень специальность выбор профессия рад я	1ps очень радостный есть выбор профессия специальность
она помогать она заниматься научать готовить печь шить они часто вместе гулять ходить в музей и на выставка	она она шить она ходить она часто вместе гулять выставка они помог	помощь учиться 1ps учить2 3ps готовить пирожки пирог шить вместе часто прогулка музей выставка смотреть2
также от до процент калорийность идти на пищеварение	пищеварение идти процент также протеинйность ихать	еще о-т <nums> до <nums> процент <dact> мы тратить н-а пищеварение
многий из они еще и работать переводчик в вуз	переводчик многий работать они вуз многий еще еще	и 3ps pl переводчик много посетить <dact> переводить работать посещать.и.то.и.это
встреча	встреча	встретить
я говорить что нужно сюда а он в другой место доставлять	говорить место доставлять он нужно другой я	1ps не 1ps indx доставка 3ps 1ps 3ps не indx
гость ничто не купить к чай	гость ничто чайка купить	гость pl ничего3 деньги не <dact> чай indx
это он собака	собака он это	это poss 3ps собака
да да постоянно калька	калька постоянно  калька	да да калька2 pl
я состоять в ассоциация слышать гид	гид состоять ассоциация слышать я	1ps есть включать содружество <dact> проводить <dact> слышащий включать
дом красиво украшаться весь делать друг друг подарок вместе играть и танцевать	друг украшаться друг друг вместе весь делать весь дом друг украшаться	дом красивый украшать все делать подарок подарок2 все семья игра танцевать
мы отда м себя полностью и жд м любовь к себя	себя мы отдавать полностью любовь себя м м м любовь	отдавать.себя pl ждать2 любить себе
важный использовать бальзам если волос повреждать и торчать	повреждать торчать важный использовать волос балзам	бывает clf clf.волосы clf.торчат получаться clf clf.волосы clf.повреждены волосы clf clf.волосы clf.повреждены получается clf clf.волосы clf.повреждены сломанный clf clf.волосы clf.торчат получаться
не ловко ну да ладно	ловко плохой	неудобно2 ладно
как это на жестовый передавать	передавать жестовый это	жест как передавать
солдат посолить и снова попробовать	посылать солдат попробовать снова попробовать	солдат немного солить новый пробовать
ведь это самый настоящий кошмар	самый кошмар настоящий это корт	страшный будет
допускать к вы приш л пациент со свой проблема и вы выяснять что у он быть психосоматический влияние	выяснять он вы приход быть вы вы допускать свой психосатический вли	случай пример человек clf clf.человек clf.приближается у 3ps есть проблема2 3ps видеть что у 3ps есть мозг <dact>
выделять деньги на школа	выделять школа деньги школьа	школа clf clf.выделять clf.деньги
когда вы чувствовать себя хорошо и человек вокруг вы чувствовать себя хорошо уровень жизнь качественно поменяться	себя чувствовать вы чувствовать хорошо уровень жизнь поменяться себя вы чувств	1ps хорошо 1ps делать для 3ps pl <dact> себе приятный все себе чувствовать хорошо жизнь уровень изменять
давать поговорить по душа	давать поговорить душа душа давать	нейтр.имп. общаться душа
у он быть одежда	он быть одежда	одежда2 нет одежда2 у 3ps есть
на следующий день они вдвоем встречаться с орел	встречаться следующий орел день вдваем они	следующий день двое встреча орел встреча
я из семья глухой мой мама и папа глухой	глухой мой глухой я глухой семья папа папа семья глухой мой	1ps семья глухой poss 1ps мама папа глухой
спрашивать у лощадь как быть всегда вместе с мальчик	быть вместе спрашивать мальчик площадь вместе	обратиться мальчик вместе indx нет
когда быть просить мало деньги то и грант вы легко давать	мало грант вы то давать быть деньги легко продавать просить	<dact> деньги мало просить деньги мало грант легко
находить	находить находить	находить
састье слышать	састье слышать	счастье слышать
говорить	говорить	говорить
вога кормить себя плюс еще инвалид кормить	себя кормить еще инвалид кормить волга кормить плюс кормить	indx <dact> себя 1ps кормить 1ps плюс еще инвалид кормить 3ps
когда знать что быть резерв на душа спокойно а когда потратиться переживать лишний раз вдруг увольнять	резерв переживать лишний увольнять знать душа быть вдруг спокойно	знать копить indx 1ps на.душе.спокойно 1ps выбросить переживать вдруг уволить думать лишний
я всерьез это никогда не воспринимать но когда увидеть он возмужать взрослый почувствовать как защемлять сердце	сердце я увидеть возмужать воспринимать защемлять он почувствовать	1ps <dact> серьезно воспринимать нет и видеть сегодня2 взрослый 1ps нравиться
мужчина схватывать чемодан в один рука сумка в другой и на ход потому что поезд уже начинать медленно ехать вскакивать на ступенька	ехать рука поезд другой уже сумка начинать схватывать медленно	мужчина2 взять <dact> clf clf.сумка clf.взять сумка clf clf.бежать что поезд начать clf поезд ехать и clf clf.человек clf.прыгнуть ступенька
деньги я не давать но выписывать рекомендательный письмо письмо поддержка начальство поставлять печать	письмо деньги выписывать письмо я давать письмо поддержка печать	1ps согласиться письмо поддерживать согласиться заполнять администратор печать качественный clf clf.держать clf.письмо clf.в clf.руке хорошо
в конец июнь начало июль уже созревать вишня черешня абрикос	конец июль уже июнь конец озревать абрикос	clf clf.плод clf.pl готовый последний3 июнь начинать июль indx вишня <dact> <dact>
сахар в кровь расти а вслед за этот расти и количество инсулин	кровь сахар количество инсулин расти расти вслед этот расти	сахар в красный увеличивать множественный и плюс множественный <dact> добавлять pl
не то чтобы он не хотеть я слушать но просто он вс это быть безразлично	слушать он хотеть безразлично это он быть весь я	мальчик н-е только не хотеть 1ps слушать тоже 3ps безразличие
он думать лишь о музыка а всякий знать что искусство эгоистично	знать всякий думать эгоистичный он искусство музыка	3ps думать только2 о музыка все знать искусство indx только2 думать о себя pl
а ефросинья петровна надо я видно просыпаться от это грохот	надо просыпаться петровный я видно ефросинья грохотка	<dact> <dact> открыть.глаза
можно делать сковоречник	можно делать сильно горяечник	мочь делать дом для птица
когда реб нок чувствовать что он не один он начинать по-другому относиться к свой родитель открываться он	начинать он свой родитель открываться он относиться по-другому один ребен	1ps <nums> нет 1ps чувствовать открытый и начать относиться папа п-о другой
очень довольный	очень довольный очень	очень довольно
за этот три год в инкубатор вы расти и становиться сильный но кроме этот пункт который я уже объяснять быть и другой способ получать деньги на свой проект	уже становиться деньги этот свой три я расти инкабатор	год <nums> выпускать2 <dact> родиться больше уже сильный выпускать2 это множественный мочь другой талантливый 2ps проект есть все включено делать карьера
я звать елена	елена я я выдавать	здравствуйте 1ps имя <dact>
утом помогать запускать обмен вещество на максимальный скорость работа щитовидный железа давать прилив энергия и хороший настроение а вечер наоборот успокаивать настраивать на хороший сон и защищать от обжорство и ускорять расход жир из наш запас	настраивать работа щитовидный энергия запас запас хороший обмен энергия вечер	утро помогать 1ps clf clf.организм clf.процесс clf.начать максимум скорость clf clf.организм clf.процесс clf.работать работать2 щитовидная.железа ш clf clf.щитовидная clf clf.организм clf.процесс энергия clf clf.организм clf.процесс и настроение хорошо а вечер2 наоборот успокоить слабость спать хорошо защищать о-т еда pl нервный отсутствие <dact> тратить запас быстрый
ну вот же у ты готовый ответ	готовый ответ ты	готовый ответ
я заканчивать учиться пойти работать туда где быть глухой	быть работать заканчивать пойти глухой я учиться	1ps учиться конец поступать2 работать2 место глухой
вот	вот	здесь
потом я подзывать свой ребенок который знать жестовый язык он весело подходить ко я	жестовый подходить знать он свой весело я ребенок подзывать который	потом ребенок poss 1ps ребенок нейтр.имп ребенок оживленный нейтр.имп 1ps жестовый язык знать clf clf.подойти нейтр.имп
начинать дуть ветер	дуть начинать ветер	ветер pl начинать
в холодильник нет еда	еда холодильник	холодно indx еда нет2 ноль скелет2
что же делать	делать плохой	что делать
ты бояться даже ветер	бояться ветер мы	2ps бояться даже ветер
в понедельник мы быть проводить прямой эфир	проводить эфир понедельник прямой мы быть	у 1ps будет понедельник завтра будет проводить п-э
Ещ дедушка с антон хотеть сделать семейный древо	дерево антон дедушка сделать хотеть семейный ес дирь	еще дедушка вместе <dact> желание делать дерево ветвь pl семья
семья это сложный но жить один невозможно	сложный невозможно семья один невозможно это жить	семья это сложный н-о счастье жить <nums> невозможный
конечно нужно чтобы кто-то вызывать скорый помощь	скорый помощь вызывать нужно кто-то конечно	конечно нужно чтобы кто заметить indx вызвать <nums>
тома находить в себя сила прощать муж хоть и даваться она это нелегко	прощать нелегко она себя даваться это муж находить сила то	<dact> успех себя сильный прощать2 мальчик муж действительно был тяжелый
работник китайский магазин в нью-йорк взять он в магазин и он оставаться там на год	он взять оставаться китайский магазин он работник нью-йорк год	магазин нью-йорк китай магазин взять и оставить <nums> время
вечерний капсула пролонгировать лимфодренажный эффект получать на первый шаг	первый получать вечерний пролонгировать эффект шаг капсула лимфодрожный	вечер капсула indx <dact> жидкий 1 <dact> был 3ps давать 1ps indx управлять clf clf.выравнивать
да вредить	вредить давать	наносить.вред
борис джонсон болеть в март	болеть март борис джонсон	3ps <dact> <dact> заболеть был <dact>
сестра пойти на бал а я нет	пойти бал я сестра	сестра двое уезжать бал 1ps не будет
в мой город нет аэропорт	мой город аэропорт	poss 1ps город аэропорт нет2
мочь быть я смочь взламывать сенсор ааа он на работа	он взламывать мочь работа ааа быть сознание смочь я	мочь 1ps мочь сломать clf clf.сенсор clf clf.стучать 2ps работать2 занято
узкий	узкий	clf clf.тонкий
вот уже не думать что из топор такой вкусный каша мочь получаться	такой уже думать получаться мочь каша топор вкусный	<dact> у-ж н-е думать не что и-з топор2 так хорошо <dact> мочь готовить
вс вокруг начинать зеленеть и цвести птица прилетать	начинать прилетать зеленеть весь птица цвести птица	все круговое движение начать зеленый начать цветы птица
а однажды в ателье зайти женщина в возраст она долго рассматривать я задавать вопрос а потом сказать что быть бы неплохо она сын познакомиться с такой девушка	женщина она сказать возраст я она женщина такой вопрос неплохо она однажды	и вдруг 3ps входить 1ps женщина возраст и пристальный взгляд 3ps вопрос.задавать 1ps потом 3ps отвечать 1ps б-ы poss 3ps сын 1ps девочка соединять знакомить
девочка она не понравиться	девочка она понравиться	девочка мама смотреть не нравиться
в предыдущий видео мы говорить о то что мы потреблять слишком много разный вкусный еда но организм не мочь потратить весь этот энергия	говорить потреблять много разный предыдущий мы потреблять слишком еда п	давно видео2 мы 1ps рассказывать 2ps что еда множественный еда некоторый вкусный а тратить indx электричество внутри.себя не мочь уже
легкий	легкий	легко2
познакомиться я предлагать и я становиться заниматься резьба	заниматься резьба я познакомиться предлагать становиться я заниматься я	знакомить 3ps предлагать 1ps 1ps заниматься резьба2 карьера
когда в первый раз участвовать совсем ничто не понятно	совсем понятно участвовать первый раз ничто	раз <nums> куда не понимать первый второй третий
у крашеный волос цвет исчезать	исчезать волос цвет красный	волосы что крашеный цвет3 исчезновение
давать ждать	ждать давать	нейтр.имп ждать2
вопрос вводить ли свой ребенок в сообщество глухой приводить ли на праздник участвовать ли в мероприятие	участвовать сообщество вопрос мероприятие участвовать глухой приводить свой праздник ребенок	вопрос 2ps свой дети 2ps включать мир2 глухой проводить мероприятие праздник участвовать
самый плохой что это в климат краснодарский край это ветер	край это самый край плохой это климат краснодарский ветер красный	плохой крупный что indx климат краснодар территория ветер
спать далеко это я дениска	это спать далеко я дениск я	какой спать продолжать 1ps <dact> имя
я заходить в строка продавец туда заходить	продавец строка заходить я заходить заходить	1ps зайти строка продавец
рассказывать про человек про то как я здесь рождаться и про вс остальное	рассказывать человек остальное рождаться то я весь	будет о человек pl разнообразие 1ps здесь родить много разнообразие рассказывать будет
весь и у я быть удобный защитный средство	средство удобный быть весь я защитный весь	все4 и себя есть удобный защита прятать защита
весь другой животное очень взволноваться	другой животное взволноваться весь очень	все другой животное pl очень волнение2
он просто оглушать я	он я оглушать оглушать	слышать звук
после урок идти к ребята	идти ребята урок	поздно урок приходить дети <dact>
так вот третьяков построить трехэтажный здание школа а рядом еще больница построить	еще больница третьяков здание рядом построить школа трехэтажный построить постро	3ps т-у создавать2 этаж <nums> и больница2 был строить clf clf.расположение clf.объектов clf.в clf.пространстве
почему это слово код являться популярный во весь мир	популярный мир весь являться слово код это весь	почему это слово <dact> популярный2 <nums> называть мир2
хорошо пока	хорошо плохо	хорошо пока хорошо
мать обещание не сдерживать и после окончание школа оля уезжать в чужой город и там и оставаться	оставаться окончание город школа сдерживать обещание оля чужой уезжа	мама 3ps алкоголь и проходить школа <dact> уезжать другой чужой город и indx зафиксировать
к пример я экскурсовод кто не приходить человек так называть экскурсант	приходить пример кто человек я называть экскурсовод экскурсант кто экскурсо	представление 1ps <dact> clf clf.толпа clf.движется clf.loc 3ps имя называть <dact>
я под кровать за двадцатьлет не то что созревать я там вполне перезревать	кровать двадцатьлет перезревать то я я вполне я	1ps лежать <nums> время 1ps детство уже уже изменять взрослый будет
это федеральный государственный образовательный стандарт	это стандарт государственный федеральный образовательный образовательный государственный	это poss 3ps государство печать наука, образование
я с она очень согласный	согласный она очень я очень	1ps мнение согласие
можно слепить снеговик	снеговик можно слепить	мочь делать <dact> шар pl
я думать что такой курс давать глухой новый возможность	давать такой глухой курс новый возможность думать я возможность	1ps думать что курс давать новый возможность для глухой
в-третьих это огромный количество энергия который обрушиваться на мы и мы не знать куда он потратить	мы огромный количество энергия обрушиваться мы это знать потратить который	третий еще это большой clf clf.поступление clf.энергии электричество это множественный clf clf.поступление clf.энергии 1ps тратить куда трудно
мой учитель сказать женщина у она дочь со сломать позвоночник что это не причина отказываться от радость плакать не нужно	отказываться она плакать это дочь нужно позвоночник причина сказать женщин	мой учитель имя дактилирование 3ps был сказать у 3ps был дочь с позвоночник сломаться 3ps говорить это н-е причина н-е радоваться плакать не
в магазин нет сыр	магазин сырой	магазин <dact> нет2
не предлагать я ехать	предлагать я ехать	просить уважать 1ps 1ps предлагать 3ps еда не.нужно
общий представление о белок жир и углевод мы мочь получать в лаборатория однако у мы в организм весь устраивать намного интересный и сложный	получать белый мочь общий весь намного лаборатория наш заинтересованный белый	это общий мочь получать только2 лаборатория poss 1ps внутри.себя все еще интересный и сложный
нет хорошо так мой подруга быстро бегать не уметь	бегать мой быстро хорошо хорошо узнавать подруга	не poss 1ps друг быстрый бежать не знать
утро принимать два капсула после еда вечер за минута до ужин	минута два вечер утро еда капсула ужин принимать утро	утро еда все4 clf clf.принять clf.две clf.капсулы вечер2 будет еда <dact> з-а <nums> минута будет еда
они бродить до утро по улица а потом поехать на вокзал и снова они место быть рядом	утро они снова поехать вокзал они быть место рядом у	согласиться прогулка с.вечер.до.утро потом вместе clf clf.два clf.человека clf.идут вокзал2 и попадать место сосед
мы не смочь поймать рыба	рыба смочь поймать мы	1ps рыба схватить не мочь
у я двое слышать ребенок	двое слышать ребенок я	1ps у 1ps дети2 <nums> слышащий
мы вс восстанавливать	восстанавливать мы весь	не.переживать
давать подумать о то что вы написать	давать то вы подумать написать давать вы подписывать	поэтому нейтр.имп строчка pl думать
в магазин пойти	магазин пойти	магазин пойти
они собираться и общаться на жестовый язык	собираться общаться жестовый язык они	3ps собираться проводить говорить.на.жестовом.языке
я только русский и английский язык	я английский язык русский русский я	1ps <nums> русский английский 2
следующий тот кто не знать жестовый язык	следующий знать жестовый тот язык кто	следующий2 кто жест не знать
я быть в италия	быть я италия италия	италия2 1ps был
саша сломать нога из-за это сегодня не прийти на день рождение	день приходить сломать нога рождение саша это сегодня нога	<dact> <dact> сломанный это 3ps не мочь приезжать день.рождения clf clf.человек clf.прийти день.рождения
жизнь закалять и я благодарный весь кто поддерживать я в непростой время помогать подсказывать	поддерживать помогать я весь кто помощь подсказывать я я поддерж	жизнь 3ps учить2 1ps 1ps благодарение все кто был сосед 3ps поддерживать 1ps 1ps тяжелый время 3ps подсказывать 1ps
да раз в неделя заниматься	заниматься неделя раз	indx неделя <nums> раз <nums> учиться
здравствовать	здравствовать	приветствовать здравствуйте
я она слушаться потому что считать что она становиться я мама я она даже так называть	она она она слушаться я она считать я называть она я она станов	1ps согласиться надеяться <dact> <dact> poss 1ps мама тоже 1ps иметь тема <dact>
еще когда человек полностью задыхаться мы останавливаться	останавливаться человек полностью мы еще задыхаться	еще когда человек полный задыхаться2 останавливаться полный тихий
совсем отрицательно	совсем отрицательно	следующий3 совсем отрицать
здесь мы также продолжать заниматься в различный кружок проводить тренинг и разнообразный мастер-класс	мастер-класс также различный продолжать проводить кружок опыт заниматься разнообразный	здесь тоже продолжать разнообразие кружок мастер класс <dact> разнообразие
либо родитель не отдавать все себя ребенок и не объяснять смысл слово на жестовый язык	жестовый ребенок ребенок объяснять себя весь отдавать родитель смысл язык	или родной отдавать.всего.себя говорить на жестовом языке рассказывать мысль слово
к сожаление не весь семья такой дружный	такой семья сожаление дружный весь	сожаление все семья такой дружба
я не мочь ты отпускать поэтому я купить билет до твой город	мой мой я я купить отпускать билет мой город я мой я мой	1ps 2ps свобода не мочь 1ps кормить билет до poss 2ps город
только вы так странно одевать	вы одевать странно	одежда3 просматривать одежда3 странный
где-то или месяц	месяц месяц	месяц <nums> месяц <nums> месяц <nums> месяц 3
вода в речка быть прозрачный так что можно быть увидеть камень на день	быть прозрачный день камень вода можно увидеть речка быть	вода река прозрачный видеть камень четко
у мы с другой быть секрет друг от друг	другой секрет другой другой мы быть другой мы другой	1ps друг вдвоем секрет иметь делить ноль
у я в план в дальнейший объявлять о возможность проведень курс обучение	план план объявлять проведение обучение дальнейший курс возможность я обучение	у 1ps есть план 1ps уже ранее объявлять о poss 1ps план обучать2 <dact> обучать2
весь человек разный у весь разный работа и характер разный то что я объяснять это не готовый формула успех главное я давать вы правильный направление	разный разный разный разный я разный я весь работа формула	человек pl разный работать2 разный характер разный поэтому 1ps объяснять это готовый2 успех все4 1ps выполнять главный направление правильный clf clf.двигаться clf.в clf.направлении
нужно что-то решать но я действительно не знать с что начинать	знать решать нужно начинать действительно что-то знать я решать	думать решать нужно действительно 1ps не.знать что с что начать
мы договариваться встречаться в определенный день я приходить рассказывать о свой проект и сказать что деньги пока на он нет	рассказывать день он договариваться свой проект приходить мы определенный встречаться я	1ps договор число попадать 1ps <dact> приходить это встречаться 1ps разговаривать2 да согласие 1ps что проект 1ps есть а деньги временный нет2 1ps желание <dact> <dact> деньги зависеть
я не понимать математика	понимать я математик  математик	математика 1ps не понимать нет3
неполный блокада дыхательный путь	блокада путь неполный дыхательный пропуск	н-е полный не останавливаться дышать
наверное вы подумать что быть лишний окошко	быть вы подумать окошко лишний наверное	наверное думать еще лишний
настоящий	настоящий конь	настоящий
бабушка и дедушка родитель папа а мама и папа родитель катя и антон	родитель антонон папа мама мама катя родитель дедушка родитель дедушка	бабушка2 дедушка это родители папа poss 3ps мама папа родители poss 3ps <dact> <dact>
еще он замечать бабочка медвежонок никогда не видеть ничто такой же яркий разноцветный красивый и удивительный	такой еще ничто он видеть удивительный медвежонок красивый так	еще замечать бабочка2 раньше медведь видеть никогда похоже яркий цвет разный и красивый удивительный
весь животное в лес смеяться над мышонок	животное мышонок весь животное смеяться лес	все животное pl лес2 смеяться угрожать2 <dact> мышь2
мелкий	мелкий	мелкий2
они связываться со спонсор который попросить предоставлять скидка или раздавать мыло бесплатно чтобы ребенок использовать он для мытье рука	они мытье рука связываться попросить раздавать использовать он который ребен	уже контактировать pl <dact> спонсор контактировать pl просить 3ps скидка или бесплатный раздавать мыло сдать pl дети2 умыть руки использовать pl уже
следующий акселератор	следующий ак сенсатор	следущий3 <dact>
общий	общий	общий
мой попугай любить человек	мой человек любить попугай	poss попугай <dact> любить человек pl
акцентировать внимание именно на это	это акцентировать внимание акцентировать	<nums> до у 1ps 1ps интерес акцентировать.внимание дети2
вот и первый рыбка ерш	первый ершшвейцарский рыбка	первый рыба2 ловить <dact>
мой бабушка любить гулять ночь	любить гулять мой ночь бабушка	poss бабушка любить гулять ночь
получаться что один апсула с утро уменьшать аппетит особенно тяга к сладкий защищать от развитие метаболический синдром инсулинорезистентность а в дальнейший сахарный диабет усиливать эффект насыщение и защищать от повторный набор вес	постоянный сахарный диабет усиливать агусторезистентность	успех капсула утро indx уменьшать2 следующий3 еда еще не.хотеть отдельный2 сладкий indx желание нет2 и защищать о-т о-т воспринимать и сахар <dact> конец и сильный увеличивать чувствовать сытый и защищать о-т обратимый вес увеличивать
я обожать что в мой работа нет однообразие всегда разный место человек информация посещать разный мероприятие	разный человек разный мероприятие разный я обохватывать разный однообразие	обожать2 что 1ps однообразно так нет2 всегда2 разный место человек pl информация разный посещать.туда.сюда разный
антон настоящий старший брат он всегда защищать свой маленький сестра если кто-то в школа иногда пытаться е обижать	брат защищать пытаться е свой старший иногда маленький	<dact> настоящий старший брат 3ps всегда защита свой маленький сестра забота случай что школа быть pl 3ps кто обида дразнить
и я становиться интересно быть ли подобный в москва	быть я становиться подобный москва интересно я	1ps интересный москва здесь есть отсутствие
человек не носить это платье потому что оно мало	платье мало человек это оно носить	человек pl н-е носить это платье почему это indx мало маленький3
здесь африка	африка	здесь африка2
мочь быть чтобы деньги оставаться на потом но на самый дело весь человек разный и у каждый быть свой причина	самый человек быть оставаться свой причина каждый разный дело мочь в	мочь быть что думать копить оставить желание н-о так 2ps pl человек pl разный причина свой pl внутрь
мучение	мучение	страдание
тонкий	тонкий	худой2
да	давать	да
в интернет быть список конкурс в свой город	свой город быть список интернет конкурс	интернет список соренование свой город
рано быть такой автомобиль красивый длинный с олень на капот	длинный такой автомобиль быть капот рано красивый олень	<dact> раньше красивый clf clf.длинный clf.автомобиль clf clf.фары <dact> олень clf clf.олень clf.лапы clf clf.олень clf.стоит
она начало что-то говорить да неожиданно замолчать	говорить что-то неожиданно замолчать начало она	3ps <dact> девочка рассказывать случай неожиданно2 молчать
несколько год назад у она к сожаление умирать мама	она несколько назад сожаление умирать год мама	несколько лет назад2 девочка poss 3ps мама смерть жалость
пожалуйста помогать мы кто если не вы	помогать вы вы кто мы	1ps просить 2ps помогать 2ps 1ps если 2ps кто дефицит
у мы весь переводчик первый категория и постоянно повышать свой квалификация	первый постоянно категория переводчик свой мы весь повышать повы	у 1ps переводчик все первый <dact> и всегда расти карьера учить карьера всегда
он быть старый я на год и наш отношение быть довольно странный	отношение странаный быть довольно старый наш год он быть я	мальчик 3ps был старший 1ps н-а <nums> лет и взаимоотношения был странный
человек говорить не мочь но он модевать покачать голова	говорить голова мочь модевать он покачивать человек	человек говорить не.мочь.сделать голова как голова кивать хорошо
невозможно	невозможно невозможно	невозможный
правильно	правильно	правильный
код собираться вперемешку	собираться код вперемешку	кода собрание смешанный
он так бояться	бояться он	о-н так страх
я подумать у я получаться резьба заниматься	заниматься резьба я я я я я поддумывать заниматься	поэтому 1ps думать резьба2 успех как
в будущее мир глухой исчезать или нет	будущее глухой мир исчезать	думать будущее мир2 глухой исчезновение будет или не.будет
это не мой тема но я смотреть немного в будущее	будущее немного мой смотреть я тема это	это н-е poss 1ps тема но 1ps смотреть чуть-чуть будущее
это прекрасный возможность для человек с различный ментальный заболевание кто действительно не мочь трудоустраиваться и он нужно постоянный сопровождение	постоянный кто действительно мочь ментальный он заболевание постоянный различ	это отличный возможность для человек pl разный pl умственный заболевание кто не мочь разделять не мочь трудоустройство 3ps нужно следующий следить
множество человек	множество человек	множественный человек pl
не понимать почему кушать что	понимать кушать что	2ps не понимать почему еда что
похоже откусывать сэндвич	похоже откусывать сэндвич сэндвич	похоже <dact> clf clf.сэндвич clf.откусить
и вот изображение стекло запотевать он начинать он протирать и когда протирать начинать проявляться картина то что он хотеть	начинать он он картина хотеть начинать он то начинать он проявляться стекло выстав	пример clf clf.изображение clf.размытое начинать вытирать когда2 вытирать появляться картина рисовать это соответствовать indx что 3ps желание похоже 1ps исправлять 3ps
также здесь рассказывать об история общество глухой о то откуда возникать жестовый язык	также глухой история жестовый язык рассказывать то возникать общество общество	и 3ps включать похоже 1ps рассказывать 2ps история раньше глухой общество жестовый.язык2 возникать
если не помогать снова производить хлопок пока ни получаться	получаться снова помогать производить оказывать получаться хлебок	бесполезный новый clf clf.человек clf.выбить clf.инородное clf.тело clf clf.человек clf.выбить clf.инородное clf.тело чередовать глаза clf clf.инородный clf.предмет clf.вытолкнуть нужно
когда медвежонок просыпаться папа не быть только вода повсюду	медвежонок вода быть папа просыпаться повреждать	когда медведь маленький3 проснуться папа пусто повсюду вода
получаться при минимальный увеличение жир обмен вещество в организм замедляться в раз	минимальный организм замедляться получаться увеличение вещество раз раз обмен вещество жир	получаться clf clf.чуть увеличение <dact> увеличение clf clf.чуть получаться clf clf.огранизм clf.процесс <dact> медленно в 1.5 <dact> медленно
я переводить различный пара мероприятие	различный пара переводить мероприятие я	1ps переводчик разный урок мероприятие
а к кто обращаться	кто обращаться	а обращаться кто
я обязанный знать военный дело	знать военный обязанный я дело	1ps обязанность знать правила военный дело
древолаз очень токсичный и бывать разный цветок желтый темно-зеленый красный черный но самый опасный золотой	черный цветок самый черный цветок темно-серый разный токсичный красный	clf clf.лягушка clf.взбирается clf.по clf.дереву у 3ps есть вредить есть бывает видеть цвет3 желтый темный зеленый красный синий черный н-о сам2 опасный зеленый цвет3 золотой
вопрос кто входить в сообщество глухой	глухой вопрос сообщество входить кто	вопрос кто включать мир2 глухой внутри
четвертый ваш мнение	четвертый ваш мнение	четвертый poss 2ps мнение
веко защекотать слезинка когда поезд тронуться но вдруг дверь в купе открываться и входить роберт	открываться защекотать вдруг дверь слезинка роберт поезд тронуться	слеза поезд clf clf.поезд clf.трогается вдруг clf clf.двери clf.купе clf.открываются мальчик clf clf.человек clf.идет то.же.самое <dact>
создавать	создавать создавать	собирать
а куст кричать соловей чтобы тот еще крепко прижиматься к шип	кричать прижиматься тот еще толвей куст крепко шипа крепко	кусты clf clf.кусты кричать птица2 imp держать clf clf.тельце clf.птицы imp
мочь быть у вы быть какой-либо вопрос или хотеть подробность я готовый вы отвечать спрашивать	быть мочь вопрос хотеть какой-либо быть отвечать подробность вы с	может.быть у ps2 есть вопрос подробный мочь ответ спросить 1ps
нападать	нападать	напатать
из жир так же как и из белок строиться клетка оболочка мембрана без жир не образовываться поэтому часть жир идти на строительство этот мембрана и не давать мы энергия	клетка часть белый клетка белый клетка разрушаться давать этот мы	<dact> indx и <dact> тоже строить клетки.организма indx без clf clf.оболочка clf.клетки это делать и-з <dact> это отдельный <dact> будет использовать строить clf clf.оболочка clf.клетки и электричество 3ps давать 1ps нет indx половина убирать
сделать такой ступенька на память красота	память такой ступняк сделать стойка красота	это indx ступенька был собирать памятник красивый
быть много направление где можно себя применять физкультура преподавание разный направление быть	разный быть направление физкультура быть можно направление применять много	1ps какой физкультура направление считать3 преподавание направление считать3 любой разнообразие3 куда все есть
а инвалид нужно быть обязательно давать путевка дом отдых специальный больница	быть нужно специальный отдых давать больница дом инвалид путевка обязательно	и а инвалид так нужно платить pl должен первый путевка отдых дать дом pl отдых дать специальность больница2
мой текущий рабочий деятельность мочь продолжаться до но вдруг я узнавать о болезнь или что-то случаться	болезнь вдруг рабочий мой продолжаться деятельность узнавать что-то я	сейчас 1ps деятельность работать2 быть хорошо мочь до <nums> мочь быть н-о узнать болезнь что случай
это значит настоящий поэтому сейчас он не мочь	значит он мочь это настоящий сейчас значит	это настоящий сейчас не мочь
поэтому я хотя и оробеть но не до конец и весь продолжать посматривать на ефросинья петровна что же она будет делать далеко	продолжать я далеко делать будет оребать весь конец еф	1ps пока 1ps чуть-чуть страшный чуть-чуть взглянуть бабушка взглянуть делать что интересный взглянуть
по разный причина по сложный работа по ещ какой-то причина просто не хотеть	разный какой-то работа причина сложный хотеть причина эдедь раз	разнообразие причина сложный условие труд ещё что-то не.хотеть
в сентябрь обычно тоже жарко	сентябрь обычно жарко сентябрь	сентябрь indx тоже
внешний	внешний	внешний
я не знать испанский язык	знать язык испанский я я	1ps испания2 язык 1ps не знать
я относиться ко весь одинаково хорошо	относиться одиночка хорошо весь я хорошо	1ps все так хорошо отношение
один ребенок будет смотреть но он это не нужно	смотреть один ребенок нужно он это будет будет	смотреть не.нужно
мой профессия интересный и необычный	интересный необычный мой профессия	poss 1ps профессия переводчик интересный необычный
однажды тамара присниться сон забросить деревня а там дочка и она звать тамара и просить скоро она находить	она присниваться она она просить она деревня находить она дочка сон присни	и однажды 3ps девочка сон изгой2 деревня и дочь кто кричать мама pl быстрый 1ps успех
в-третьих помимо углевод жир и белок пища давать наш организм витамин и минерал который регулировать различный процесс	наш организм различный пища различный регулировать углевод белый давать организм пища	третий еда <dact> <dact> <dact> вместе еще 3ps давать 1ps плюс полезный <dact> что метаболизм правильно работать внутри.себя все
я должный уметь командовать отряд	отряд командовать я должный уметь отряд командовать	1ps нужно знать пример группа военный руководить
я часто пропускать школа из-за то что сидеть с младший сестра	часто то я школа младший сидеть пропускать сестра	1ps часто прогуливать школа почему 1ps сидеть вместе младший сестра
общий	общий	общий2
что хотеть сказать	хотеть сказать хотеть	желание сказать
бывать что в связь с погодный условие обледеневать и оборваться провод но опять же такой случаться редко	оборваться условие случаться такой облелять погодный связь провод бывать	быть попадать <dact> мороз дождь быть clf clf.провод clf.pl провод clf clf.провод clf.порваться редко
так быть всегда сказать сова и это никогда не изменяться	изменяться сказать быть это сова	разговаривать2 <dact> пусть всегда ладно думать изменять не.будет2 ладно
через ассоциация мы постараться сделать так чтобы вы в свой город например в новосибирск находить филиал этот ассоциация и приходить туда	свой приходить ассоциация мы сделать город ассоциация например постраться филиал на	1ps через содружество 3ps 1ps адрес список 1ps будет раздавать2 все это 3ps адрес свой новосибирск 3ps другой город будет приходить2
а если я не прийти домой папа и мама обязательно сообщать в милиция	приходить обязательно милиция сообщать я папа домой мама	1ps домой не будет родители должен полицейский милиция предупредить
лето сам себя нужно купаться	сам нужно лето купаться себя	indx лето обязательный купаться
когда наступать ночь они отдыхать	наступать ночь они ночь опускать ночь отпускать	когда ночь начало отдых
это я очень нужно потому что я получать различный информация о музей город благодаря этот организация	это организация очень информация получать я я различный музей это город нужно	1ps indx быть включать это нужда indx различный pl получать информация все получать вечный у 3ps содружество перечислять2 получать2 indx быть музей работать2 включать indx город страна indx 1ps вечный
мать девочка сильно выпивать после развод с отец и оля всегда сторониться ребята чувствовать себя обделять	девочка себя отец чувствовать сильно обделять мать развод сторониться девочк	мама poss 3ps девочка проходить расстаться папа сильный алкоголь и <dact> 3ps всегда2 <nums> лишний2
вода холодный или ты притворяться	притворяться вода холодный ты	вода холодный или 2ps притворяться
благодаря вот этот механизм ускоряться снижение вес	снижение механизм вес ускоряться этот	благодарение это indx собирать indx успех вес худеть
дочка сидеть зажиматься в угол	сидеть угол дочка зажиматься	дочь сидеть угол прятать
но иногда смотреть на человек и думать что у он жировой запас даже слишком много и пора останавливаться	смотреть слишком он останавливаться запас думать много плохой человек пора ин	видеть человек 3ps <dact> жировые.запасы куда хватит конец
мы с она знакомый	знакомый она мы	1ps pl вместе знакомый
я приходить в тот школа в который среди слышать ребенок быть код приходить туда смотреть помогать	приходить приходить тот слышать быть который ребенок школа код смотреть помог	кто indx дети слышащий кода включать 1ps помогать 3ps 1ps приходить 3ps проводить indx приходить смотреть indx
обнимать и до следующий встреча	следующий обнимать встреча	обнимать все до следующий встреча пока
подключаться быть вы ждать	быть вы ждать подключаться	ждать2 poss 2ps 2ps подключаться 1ps
вы быть получать различный поручение	поручение вы быть различный получать	желание пример поручать различный
я быть учитывать возможность ваш город	учитывать возможность быть ваш город я возможность	1ps обучать2 потом потому.что город poss 2ps
также вы мочь находить я в соцсеть ВК фейсбук и написать я задавать вопрос я отвечать	отвечать я я вопрос задавать я я находить также мочь	кто узнать2 мочь 2ps 1ps соцсеть ответ в-к фейсбук написать вопрос 1ps отвечать
следующий вога клуб глухой	глухой следующий клуб вога	следующий2 <dact> клуб глухой
я сам глухой общаться на жестовый язык мой родитель а также бабушка и дедушка тоже глухой и мы нормально общаться на жестовый язык	глухой общаться жестовый сам глухой также мой язык наш глухой нормально диа	1ps сам2 глухой poss 1ps говорить на жестовом языке poss 1ps родиетли глухой бабушка дедушка глухой 3ps pl говорить на жестовом языке нормально
если бы я не пойти работать переводчик я бы выбирать направление сурдопедагог и обучать бы ребенок с нарушение слух	нарушение работать переводчик я пойти я слух сурдопедагог	если 1ps поступать работать2 переводчик 1ps выбирать другой специальность направление <dact> преподавание обучать2 дети2 нарушение2 слух
да	давать	д-а
укус лори мочь вызывать анафилактический шок и даже смерть говорить что лори подражать змей ядовитый	смерть лор ядовитый мочь анафилактический лор подража	это 3ps кусать мочь 1ps <dact> 1ps смерть мочь2 это осторожно <dact> 3ps копировать змея похоже
о нет ты не мочь поехать на королевский бал в такой вид	такой мочь королевский поехать вид бал мой	нельзя уезжать королевский праздник бал такой 2ps
мы видеть что человек стоять взгляд испуганный	испуганный видеть человек стоять мы взгляд видеть	1ps 1ps видеть человек стоять глаза какой clf clf.глаза clf.расшириться напуганный indx кашлять2 останавливаться
ехать нужно быть далеко но луиза не мочь пропустить такой событие	ехать такой луиза мочь далеко быть нужно событие пропускать	поехать далеко н-о пропускать3 не мочь
семья это труд друг о друг забота	друг это друг семья друг труд заботать	семья это труд делать друг.друга забота
например на помещение	помещение например например	пример комната комната
на седьмой место муравьед	место муравьед седьмой	следующий3 <dact>
он вчера не купить мясо	мясо он вчера купить	о-н 3ps вчера мясо покупать не был
он быть страшно но он стараться не показывать это	страшно показывать стараться он быть он это	о-н был страх н-о стараться н-е показывать
жир сжигаться быстро и превращаться в энергия	энергия быстро превращаться сжигаться энергия жир	<dact> огонь быстрый изменение энергия
и как раз когда мы общаться в фейсбука там быть человек по имя аркадий белозовский	раз общаться быть аркадий имя человек белозовский микроббука мы	<dact> <dact> связь когда фейсбук indx был беседовать indx имя <dact> <dact>
по-прежнему пусто	по-прежнему пустой	пустой то.же.самое
у я быть принтер	быть я факс кабель	1ps принтер2 иметь
а также углеводный пища потому что повышаться сахар и инсулин в кровь	также пища повышаться углеводный кровь инсулин сахар	плюс <dact> еда indx тоже почему сахар2 выше <dact> кровь тоже выше
для то чтобы вы быть заразный у вы не должно быть антитело	антитело быть должно быть вы вы то вы быть вы быть вы бы	если 1ps заразный 1ps необходимость внутри защита не иметь
мой жена тоже учиться в ЛВЦ она знать	знать она лвц мой жена учиться жена	poss 1ps жена лвц учить2 знать пример
в это институт учиться глухой и я там быть	глухой это институт быть учиться я	институт глухой толпа есть indx это 1ps был indx
код из разный страна сразу узнавать друг друг радоваться начинать взаимодействовать друг с другой	другой разный другой страна другой другой разный другой начинать радоваться	глаз знать poss 1ps 1ps пример 1ps италия2 русский пусть <dact> 3ps одинаковый 3ps нейтр.имп радость clf clf.взаимодействовать общаться
следующий этап начинать копить на случай если оставаться без работа увольняться тогда что делать а резерв всегда быть	работа копить быть начинать следующий резерв оставаться увольняться этап случай	потом следующий все4 потом начинать копить вдруг 1ps не.работать уволиться что pl делать оставить есть
поэтому хром уменьшать тяга к сладкий	уменьшать хром сладкий тяга	<dact> уменьшать2 3ps тянуть 1ps сладкий
хорошо	хорошо	хорошо
абсорбция другой соединение хром незначительный и составлять мало	хром другой незначительный соединение абсорбция составлять мало незначительный другой	<dact> соединение успех мало меньше <nums> процент
за вертолет платить кто будет	вертолет платить кто будет будет	вертолет деньги кто будет
почему	переставать	почему
у мой брат быть чистый носок	быть носок брат чистый мой	poss 1ps брат чистота носки иметь
изменяться мир ваш семья друг и коллега весь изменяться	друг семья мир изменяться ваш изменяться коллега изменяться весь другой	ваш семья мир изменить друг pl вместе работать все изменить будет
это агенство вообще мочь выделять переводчик на любой мероприятие вы же знать что вы по закон положенный переводчик поэтому не надо стесняться он просить	надо переводчик вы полагать вы вы знать вы вы вы войско переводчик	это indx это выделить перевод indx любой деятельность что соревнование indx подать.заявление и обратиться 2ps перевод пожалуйста обслуживать все терпеть должен закон indx есть все должен обслуживать перевод
получаться я продолжать работать и плюс обучать студент будущий переводчик	будущий переводчик продолжать получаться работать я обучать продолжать студент плюс	1ps получать2 1ps продолжать работать2 оставаться2 продолжать еще работать2 плюс 1ps учить студент2 будущее переводчик
гордиться	гордиться	гордый
вдруг ларсить замечать вдалеке свой папа	замечать свой папа вдруг вдалеку ларшать	случай <dact> замечать clf clf.вдалеке indx папа видеть
следующий рыба фуга большой круглый рыба с пятно	круглый фуг следующий рыба рыба большой пятно следующий рыба рыба	изменить.направление рыба2 <dact> clf clf.рыба clf.круглая пятно pl clf clf.рыба clf.круглая
говорить голос и жест одновременно	говорить одновременно жест голос	жестовый язык
привет	привет	привет
это специальный группа слышать ребенок у который родитель глухой	родитель группа который специальный глухой это слышать ребенок родитель	это специальность группа дети2 слышащий poss 3ps папа глухой
верно	верно	правильно
во-первых в состав максимально эффективный комлпекс компонент экстракт гарциния и пиколинат хром	комлпекс состав максимально гавалия компонент пиколинат эффективный во-	первый собирать indx есть тупик полезный общий <dact> и <dact>
она входить вытирать рука о полотенце	она полтора вытирать входить рука	clf clf.человек clf.идет потирать.руки
вдруг он услышать в лес возмущать разговор зверь медведь заяц белок птица	он вдруг возмущать белый птица разговор медведь заяц звер	слышать indx лес что разговаривать2 <dact> что indx был разговаривать2 медведь возмущаться заяц <dact> птица множество смешанный
молчать	молчать	молчать
что за надоедливый крыса что ты нужно	надоедливый нужно крыс нужно ты	случай крыса2 вредный что желание
например масло коллаген и то что иметь глубокий увлажнение чтобы ухаживать за волос	иметь например волос увлажнение то глубокий коллаген масло хорошо	пример масло ухаживать глубоко масло <dact> заботиться что был
я белый мишка с северный полюс	северный белый мишка полюс я	1ps белый медведь жизнь северный.полюс
приходить посмотреть дом рядом с лес там жить мальчик который играть в лес	приходить рядом лес лес который мальчик играть посмотреть дом лес жить	приходить2 смотреть2 рядом дом indx мальчик жизнь территория близко <dact> indx indx мальчик был indx дерево pl игра
нужно поставлять ряд задача написать устав	поставлять задача ряд нужно написать устав задача поставлять устав нужно	нужно поставить pl список задание pl <dact> список список <dact> закон
чужой	чужой	чужой
у я в голова не укладываться вообще вот такой вот случай быть	вообще такой случай быть голова я случай уплачиваться	1ps 1ps тупик ап попадать случай был
сделать маленький десятисекундный репортаж и показывать	показывать десятисекундный сделать репортаж маленький маленький	видео2 маленький4 <nums> секунда отправлять 3ps новости показывать
запираться	запираться	выключить
скоро вс починять	весь скоро начинать	скоро чинить готовый будет
следующий лебедь очень красивый птица который жить пара и с который у мы связанный много представление о любовь	который пара мы связанный жить следующий красивый птица лебедь много	следующий3 <dact> clf clf.птица clf.машет clf.крыльями clf clf.длинная clf.шея красивый clf clf.два clf.лебедя clf.склонили clf.друг clf.к clf.другу clf.головы всегда2 clf clf.два clf.лебедя clf.склонили clf.друг clf.к clf.другу clf.головы милый видеть всегда2 внутри любовь2 clf clf.два clf.лебедя clf.склонили clf.друг clf.к clf.другу clf.головы clf clf.птица clf.машет clf.крыльями
и я весь время поглядывать на ефросинья петровна	петровный время я ефросинье весь поглядывать	1ps всегда2 видеть взглянуть бабушка 3ps делать что
я показывать презентация	показывать я презентация	1ps показывать мультимедийная.презентация indx
привет я звать елфимов светлана вот мо жестовый имя	светлый мой светлый я имя жестовый звать ельфим привет	аплодисменты 1ps имя <dact> <dact> poss 1ps жестовое.имя sn
сейчас жестовый язык популярный в мир слышать	мир популярный жестовый сейчас язык слышать	сейчас жест известный indx мир говорить
соглашаться	соглашаться	согласие
в Instagram быть группа мама в дело	дело быть группа мама группа	в instagram 1ps есть группа мама дело indx
даже к подросток нужный другой подход	нужный другой подросток подход	даже подросток переезд средний2 другой работа будет
например я работать в технологический музей видео гид и у они там очень хороший финансовый положение	хороший работать например они положение очень например гид технологический музей	пример 1ps делать технология музей и indx поручать видео <dact> indx финансирование2 лучше
перечить она не сметь	перечить сметь она	перечить
следующий жестовый пение театр глухой история или рассказ на РЖЯ	следующий глухой жестовый пение следующий история рассказ ржа театр пение	следующий2 жест пение театр глухой poss 3ps история жест рассказ <dact>
ребенок не осведомлять об это почему	осведомлять это ребенок	3ps pl не знать почему
оказываться очень важный знать что у он быть друг	знать важный он быть другой оказываться очень очень	оказываться очень важный если знать у 3ps есть друг
что нужно делать	нужно делать делать	что делать нужно
привет	привет	привет
или написать свой мнение	свой мнение написать свой	или poss 2ps pl мнение написать
это подходить то кто хотеть но не мочь копить	хотеть подходить копить мочь это кто то	есть кто желание н-о не.получаться копить подходящий объяснять
смерть дорогой цена за красный роза восклицать соловей	дорогой смерть соловей красный роза восклицать цена	смерть дорогой clf clf.вносить clf.деньги обмен2 красный цветок отвечать птица
отражение роза в серебряный зеркало отражение роза в недвижный вода вот каков быть роза расцветать на верхний побег куст	верхний роза зеркало вода роза каков побег отражение расцветать	типа река отражение цветок нежный сиять так2 нежный светлый был цветок расти кусты clf clf.цветок clf.распукается clf.медленно
вопрос как вы относиться к инклюзивный образование когда глухой и слышать учиться вместе	относиться слышать вы вместе инклюзивный глухой учиться вопрос	вопрос инклюзия образование2 говорить глухой вместе poss 2ps относиться как
и самый сложный это сам человек	самый сложный самый человек это	сам2 сложный это человек pl сам2 сложный
старый солдат идти в отпуск	старый идти отпуск солдат	старый солдат идти отпуск
следующий зима	следующий зима	следущий весна
нормально весь	весь нормально	нормально
восхищаться	восхищаться	восхищаться
у слышать билет стоты дорогой	стота дорогой слышать билет	у слышащий стоимость деньги больше
и что же теперь делать раз нет	раз делать теперь теперь	отсутствие pl что делать
ах какой счастие восклицать он	какой он восклицать счастие	счастье какой счастье кричать
