Russian	Predicted	Truth
а когда дед мороз вернуться домой маленький дед мороз приходить к главный и сказать а я то вон в лес тоже подарок раздавать	где дед мороз вернять дом семья сильно сильно	indx дед.мороз clf clf.группа clf.переместить домой clf clf.группа clf.переместить дед.мороз маленький встретить приходить обращение главный 1ps был лес подарок clf clf.перечислять
а мачеха лишать я весь радость	чемпион лишать я весь радость	мама второй 3ps все радость давать 1ps ноль
зачем я хотеть изменять свой привычка тратить и начинать копить	зачем я труднотатить мочь повычка копченный и начинать	зачем желание изменение все4 привычка тратить все4 желание именение привычка свой изменение тратить и копить думать
оказываться впервые это появляться в америка	результат indx оказывать впервые это иметь впервые Америка оказывать в	америка есть poss 3ps 3ps рассказ 1ps интересный америка первый прогресс
я вчера не стирать белье	я стирать белье	1ps вчера стирать <dact> не был
она один за другой скидывать с себя туфля и прямо в один чулок подходить к дверь и у я от радость заколотиться сердце	есть тоже мочь я отъезд 2001 2005 2009 2009 2009 2009 2009 2009 2009 2009	обувь2 убирать чулок бродить дверь 1ps думать радость 3ps скоро открывать.дверь сейчас скоро радость сердцебиение
тогда как	тогда так оставить тогда так оставить тогда так оставить тогда так остав	<dact> дальше <dact>
заиграть первый луч солнце а друг уже у река	есть тоже улицать первый лучей улучшать первый лучей	утро солнце друг уже рядом река
я весь устраивать я быть интересно учиться и скоро я уже сам начало выполнять даже сложный заказ	я вчера выполнять нормально главный заказ	1ps спокойный2 1ps был интересный учиться и время clf clf.время clf.идет 1ps уже сам2 получать даже сложный 3ps заказывать 1ps
мы отдыхать	мы отдыхать мы отдыхать	мы отдых
нигде	нигде нигде нигде нигде нигде нигде	<dact>
почему	поэтому почему поэтому почему поэтому почему поэтому почему поэтому по	почему
он уметь кататься на лыжа	мы умить лыжа	3ps знать лыжи
я не понимать то ли она плакать то ли смеяться	я не знать то ли мочь точка плакать то ли молярный	1ps видеть не понимать 3ps плакать или смеяться
в общий немного эмоционально получаться	общий не мочь эмоционально получать сильно эмоционально родной не мо	результат эмоция давать
сегодня мы разбирать ещ один опасный ситуация связанный с дыхание	сегодня мы изучать с дыхание	сегодня объяснять ещё <nums> опасность связать дышать
ты я не только разозлить но еще и расстраивать	ты я нормально нормально нормально нормально нормально нормально нормально нормально	2ps н-е только2 злость 1ps и плюс 1ps депрессия
хорошо радоваться тогда и дочь быстро поправляться	результат indx нормально радовать тогда нормально главный тоже мочь тоже мо	пусть радоваться влиять 3ps дочь быстро здоровый будет
например в россия быть свой традиция	если говорить мой традиция	группа пример россия есть свой традиция
мочь быть и я вы помогать	мочь мочь и мочь мочь мочь мочь мочь мочь мо	мочь быть говорить 1ps помощь
сейчас мочь даже слышно в микрофон	если мочь даже слышать мочь даже слышать мочь да	мочь быть немного слышать микрофон
кролик увидеть в цветок фея	ролик видеть в цветок фей	кролик что цветок и <dact>
он долго плыть и замечать вдали берег	indx плюс плыть плюс плюс плюс плюс плюс плюс	долго clf clf.плыть clf.на clf.бочка замечать видеть indx clf clf.берег
жаль что я туда вс равно не попадать	жаль что я все нормально все нормально все нормально все нормально все	жалость 1ps тоже indx попадать невозможный
не весь похоже понимать как это делать для себя а не для другой	что это для себя для себя для не мочь	себе делать похоже все не понимать как 1ps для 3ps делать
он отравляться	мы отравлять не	яд
много гриб собирать мальчик в лесной часто	паразит собрать ребенок в лесной часто	много гриб собирать2 лес
без видео плохо но ладно я вы рассказывать сам история про англия	indx выдуманный сам история про плохо информация 1ps : 3ps indx выдуманный	видео2 indx плохой 1ps 2ps 1ps рассказывать 2ps англия indx <dact>
он замечательно п к печение любой форма например в вид зв здочка лочек	indx так оставить плавание плюс lочка плюс печь плюс печь	это 3ps идеальный печь печенье <dact> вкус любой это 3ps уметь форма звезда ель разный pl
это глагол прилагательное	есть гладательное прилагательное прилагательное прилагательное прилагательное прилагательное	<dact> <dact>
к себя он приглашать я бояться но однажды он напрашиваться ко я на чай и увидеть мой условие жизнь предлагать пожениться и переезжать к он	есть тоже мочь мочь мочь мочь мочь мочь мочь мочь	1ps себя дом страшный 1ps приглашать 3ps н-о вдруг о-н 3ps обратиться 1ps imp чай пить о-н 3ps видеть 1ps poss 1ps условие2 все жизнь видеть imp жениться и переезд к 3ps
и вы обязательно нужно давать ответ рассказывать	indx дети трудно давать ответ	2ps pl обязательно нужда ответ pl рассказ pl ответ pl
когда мы отжимать волос вода на они оставаться	если мы отжимать волос вода на имитация	н-о 1ps жать вода clf clf.вода clf.на clf.волосах что необходимость вода оставаться indx есть
хотеть продолжать тема созависимость пренебрежение себя	желание продолжать тема соотношение силей поменять тема соотношение силей	привет
пищевой волокно связывать большой количество вода в кишечник превращать е в гель который затрудянуть усвоение углевод что сказываться на снижение уровень колебание сахар в кровь	что глубоко мирный сильность большинство волокно связывать большинство сильно	еда волокна успех связь3 только2 больше жидкий вода кишечник успех изменять <dact> и успех <dact> indx конец и успех 3ps давать 1ps уменьшать2 уровень колебание кровь
в строчка выбирать вариант или	строка вызывать вариант или	строчка связать <nums> 2ps выбрать <nums> ответ
когда появляться проблема нужно быстро придумывать как они решать	где создавать проблема необходимость проблема трудно придуманный проблема решать	проблема2 появляться быстро решать что придумывать быстро решать
потом я становиться искать какой-нибудь конкурс и наш л один который проводить среди слышать проводиться он два или три день в общий сложность	заем я начинать это уже сильно сильно сильно сильно сильно	1ps искать соревнование indx говорить соревнование 1ps все включено это все включено говорить соревнование <nums> день <nums> день <nums> факт2 indx дактилировать
у я быть я крутой у я быть связь	я делать я глубокой у я	1ps мочь круто 1ps связь2 есть
я тоже хотеть ходить на бал	я тоже мочь ходить на блин	1ps тоже желание посещать pl clf clf.пышная clf.юбка танцевать <dact>
мы знать это животное по мультфильм оно выглядеть так мило что мы и не думать о то что оно опасный а оно опасный	мы знать это нормально главный аемое мультфильм о будущее дума	знать вы животное2 мультфильм2 интересный clf clf.милая clf.пушистая clf.мордочка милый 3ps думать неопасный н-о 3ps опасный есть
наш организация существовать с го год	мы создавать сго год	это poss 1ps pl организация существовать уже <nums> год
видеть по-разному	по-разной видеть по-разнойном	видеть разный
второй шаг	вторая шаг  второй шаг	второй шаг <dact>
что вообще мочь сделать мы счастливый легко и быстро	результат indx мочь сделать мы трудно и трудно и трудно и трудно и	как вообще что влиять на 1ps мочь мы делать счастье очень легко2 быстро2
подруга рассказывать о свой проблема я тоже поделиться свой	подруга рассказывать о мочь проблема я тоже мочь мочь мочь	друг 3ps рассказывать 1ps собственность проблема2 3ps рассказывать 1ps 1ps тоже 1ps рассказывать 3ps делить
хорошо	нормально нормально нормально нормально нормально нормально нормально нормально нормально	хорошо
немного зима посмотреть и лето быть	есть плюс лето смотреть и лето смотреть и лето смотреть	немного зима смотреть2 лето есть
хитрый	хитрый хитрый хитрый хитрый хитрый хитрый	хитрый
номер три это животное который называться древолаз	человек иметь животной называть древолаз	еще есть животное2 назвать <dact>
а человек видеть мир по-разному	человек видеть мир по-разной ошарашенный мир по-разной оша	а человек pl видеть различный
в год в павловск построить ленинградский восстановительный центр	вчера вчера вчера вчера вчера вчера вчера вчера вчера в	смотреть <nums> год <nums> год павловск <dact> indx стройка clf ленинград восстанавливать центр
мой бабушка не любить гулять ночь	мочь не любить гулять ночь	poss 1ps бабушка2 не.любить гулять ночь
нет так нет ну и ладно	есть нормально нормально нормально нормально нормально нормально нормально нормально нормально	нет2 так нет2 н-у
такой человек называть элита	такая человек называть элита	новый все человек pl назвать <dact>
сейчас я видеть весь больше и больше небольшой команда который пытаться что-то делать как-то развиваться	я видеть это уже сильно сильно сильно сильно сильно сильно	сейчас всё 1ps видеть больше маленький3 команда и-п сам2 достигать так развивать
ребенок весь понимать	ребенок весь знать ребенок весь знать	все дети понимать2.наизусть
няня весь собирать и выбрасывать а мальчик давать новый белый с блестящий мех	няня давать  ново русский и выбрасывать ащий а	няня2 ладно собирать2 выбросить2 мальчик давать новый белый мех блестящий
для кто-то нужно утяжеление для кто-то чтобы быть разглаживание	кто-то нуждавать разглаживание кто-то есть кто-то	<dact> кто тяжелый clf clf.волосы clf.тяжелые <dact> кто clf clf.волосы clf.гладкие clf clf.волосы clf.лежат clf clf.волосы что был
начальник говорить мы же готовый он взять у мы быть такой рабочий место но по факт человек с инвалидность никогда не пойд т на это место	профессионал говорить на это уже русский плюс русский плюс русский плюс	начальник говорить мы готовый принять такой место у 1ps есть приглашать но п-о факт2 никогда это место инвалид вступить.не
ты должный позвонить мама а то она будет беспокоиться	ты должный позвонить мама а тоже мочь	2ps должен мама 1ps звонить.по.телефону 3ps 3ps волнение будет
я сидеть в свой комната учиться не пойти но жить на что-то надо быть	я сидеть в головный дом семья indx не мочь2 жить на	всегда2 сидеть комната учиться нет нужно деньги жизнь
я обращаться и в другой место например в вога и там я тоже оформлять письмо поддержка такой образ уже они у я быть несколько	я обращать нормально главный образ indx уже русский плюс русский	другой pl посещаемость надеяться indx и 1ps тоже <dact> 1ps обращаться <dact> тоже indx 3ps поддерживать 1ps печать 1ps повезло clf clf.складывать clf.письма clf.вместе уже
я не нравиться яркий одежда	я не любить яркий одежда	1ps яркий светлый одежда2 не нравиться
глупый	правый аргумент держать глупый	дурак
сейчас для наш человек это возможность действительно заниматься любимый дело	результат indx для нас для нас для нас для нас для нас для	сейчас мы человек pl это возможность действительно работа любить работа
если педагог видеть что он разговаривать хорошо и весь понимать то он без проблема идти в отделение и учиться год	если человек видеть что мочь нормально нормально нормально нормально нормально	если смотреть ребенок разговаривать2 хорошо понимать все <nums> подразделение год <nums> учить2 не
потом домой приходить и мама просить еще урок проводить	сестра прозывать еще урок русский проповедовать еще урок проповед	домой мама еще считать3 уроки
например двое мой ребенок говорить на жестовый язык	есть ребенок говорить на жестовый язык	дополнение пример poss 1ps дети <nums> глухой не говорить на жестовом языке
почему у мы в россия это не популярный	поэтому поэтому уже русский плюс не мочь поэтому уже русский	1ps россия популярный нет2 почему
журналист просто бер т этот новость и публиковать на сайт с красивый картинка	редактор так оставить этот новости интервью	1ps взять публиковать 1ps отправлять 3ps <dact> красивый картина
я жить в краснодарский край	я жить в краснодарский край	1ps жить кавказ место краснодар территория
нужно изучать основа чтобы иметь общий пердставление о они чтобы экскурсовод мочь об этоя рассказывать	результат indx изучать основа что indx родной учиться родной учиться родной улица	основной2 нужда изучать что общий получать воображение 3ps pl рассказ indx будет экскурсия человек экскурсия человек
я вы совсем не знать но я кажется готовый смотреть в ваш глаз вечность	я вызывать это нормально я смотреть это нормально смотреть это нормально	дорогой девочка знакомый не 1ps 2ps совсем не знать н-о 1ps казаться 1ps poss 2ps глаз pl готовый зрительный.контакт вечность
а этот мужчина быть сантехник который чинить прорыв канализация и который обливать дерьмо тома давать он халат муж и разрешать подождать пока он привозить чистый вещь	indx так оставить прорывчик испытывать прорывчик или нет общий пут	а мужчина2 это кто сантехник <dact> сантехник 1ps исправлять 3ps туалет канализация clf clf.облило clf.из clf.канализации грязь туалет <dact> для халат муж и зафиксировать пока приносить чистый poss 3ps одежда3
скоро быть праздник	скоро пример заводить праздник	скоро будет праздник
пока спасатель ехать мальчик сидеть рядом и следить	пока спасатель ехать кругом ищет знакомить ось ищет знаком	пока спасать clf clf.человек clf.прийти 3ps мальчик рядом следить н-о жалость
весь целый весь пока	результатый целый весь целый весь целый весь целый весь цел	воздушный.поцелуй аплодисменты
усердный	усердный усердный усердный усердный усердный усердный у	усердно.трудиться
открываться дверь	царь открытивать дверь	открывать.дверь
он мочь бить себя по грудь или по стол пытаться показывать что он плохо и нужный помощь	indx мочь бить себя по грудь или мочь нормально главный путь	получаться 3ps clf clf.хлопать clf.по clf.грудь clf clf.хлопать clf.по clf.стол тоже показывать все 3ps помогать 1ps тоже плохой
представлять что инициативный группа хотеть разрабатывать проект который помогать избавляться от этот проблема и не давать она развиваться	что инициативный группа трудно делать избавлять2 инициативный инициативный	ладно группа гап делать indx проект проблема2 убирать живот развитие нет проблема убирать
жертва это когда вс что ты делать ты делать в ущерб себя	ты делать это ущерб себя в ущерб себя в ущерб	<dact> называть <dact> что делать 1ps делать отдавать.себя себе думать нет
медвежонок плыть на льдина	освежитель трясти на льдина трясти на льдина трясти	медведь маленький3 clf clf.круглый clf.предмет clf.плыть clf clf.толстый clf.лед <dact> clf clf.запрыгнуть clf clf.на clf.четырех clf.лапах плыть
я этот никто не учить	я этот никто не учить никто никто не учить	1ps научить 1ps никто
например дма она заставлять она делать самый тяжелый работая	если дма заставлять самый тяжелый работа	например дом самый сложный тяжелый труд clf clf.сесть clf.на clf.шею
на улица быть тепло и мальчик хотеть пойти гулять однако начинаться дождь	результать покидать тепло испытывать дождь олегчать олег	indx смотреть улица теплота мальчик желание выходить гулять начать дождь
смотреть на вы	вы смотреть на вы	смотреть 2ps
что там	что есть что таможня что есть что таможня	что indx
он облизываться	мы обрезать огонь	вкус облизывать
идентичность я глухой и ты глухой	ты глубоко мир глубоко мир глубоко мир глубоко мир глубоко мир глубоко мир	следующий2 яг 1ps одинаковый 2ps 1ps глухой кровь2 2ps глухой 1ps одинаковый 2ps
если весь быть копить не нужно откладывать на всякий случай	если если если если если если если если если	копить 1ps копить не.нужно все есть это запас вклад
сура в адаптис плохой перевод в субтитр такой замечание	суат в адаптированный переводчик плохой переводить субтитры так оставить порт	<dact> <dact> плохой субтитры перевод плохой замечание2
у я нет сила	я нет сила	1ps сила дефицит
этот верхний пункт сокращать но затратный ресурс быть всегда	indx плюс верхний центр сокращать нодорогать но нормальноченный путь все	это clf clf.деньги clf.уменьшаться <nums> расходы <dact> всегда постоянный тратить pl
здесь жить дружно поколение старший бабушка и дедушка средний мама и папа и младший ребенок катя и антон	где жить родной дом семья испытывать родной дом семья	indx дружба жить вместе <nums> поколение старший бабушка2 дедушка второй мама папа третий младший дети <dact> <dact>
я должный завершать еще пара важный дело пока	я должный завершать еще пара важный дело пока	1ps должен конец <nums> важный дело пока
понятно	понятно понятно  понятно	понятый
сегодня мы продолжать разбирать программа slim	результат indx продолжать понятия slim	сегодня2 продолжать <nums> исследовать <nums> д <dact>
но сначала давать разбираться как усваиваться пища	но инача давать пища	н-о исследовать <dact> 1ps еда воспринимать <dact>
рассказывать еще	еще рассказывать еще еще еще еще еще еще еще	жестовый язык кто еще был рассказывать
терять	ранеять терять терять  терять  терять  терять	потерять2
он приносить одеяло из дом и накрывать собака обращаться к взрослый за помощь	есть собака приносить одеяние из дом и называть одеяние indx обращать	одеяло дом clf clf.взять clf.принести одеяло обращаться взрослый помогать 3ps 3ps
даже мэр город приезжать чтобы успокаивать мальчик	есть город приезжать чтобы насеком мы приезжать чтобы приезжать что	и даже <dact> город поехать гость 3ps 3ps успокоить 3ps 3ps pl
например компьютер ноутбук проектор стул стол и всякий вещь	если компьютер шить шить плюс шить ноутбук и сякий вещь	пример компьютер ноутбук проектор мелочь стул pl стол был
здравствовать	здравствовать здравствовать	здравствуйте
сейчас я объяснять как и что	indx объяснять главный и что я объяснять главный и что я	1ps сегодня2 1ps рассказывать 2ps что <dact> это
она просыпаться и она быть очень тесно	indx просыпчать испытывать нормально главный нормально главный нормально глав	проснуться и тесный был нормальный тесный
идти дождь и мы решать оставаться дом и посмотреть фильм	мы решать оставить дом и посмотреть фильм и посмотреть фильм и по	дождь 1ps думать решать оставаться дом и смотреть2 фильм2
весь что она удаваться находить это работа дворник в соседний двор но больший она и не нужно быть главное что хватать платить за квартира а на ехать она надо быть совсем немного потому что она почти ничто не есть и похудеть до неузнаваемость	есть тоже люди кто должен получать2 сосед indx плюс сосед	и все что мочь2 успех только2 работать дворник сосед indx территория н-о дворник достаточно квартира платить есть деньги еда должен нет много <dact> чуть-чуть еда нет ничего2 худеть видеть лицо узнать нет
кто она резать	кто резать кого кто резать	3ps кто 3ps разрезать 1ps
что вообще представлять себя этот организация и зачем она нужный	результат indx организация представлять себя этот организация	это организация здесь для что
видимо становиться больше сажать культура и из-за большой количество урожай он становиться собираться поздно	есть мочь мочь мочь мочь мочь мочь мочь мочь мочь	больше clf clf.сажать clf.в clf.землю урожай собирать2 выше начинать позже собирать2
в это место очень много турист благодаря то что здесь много исторический здание	есть тоже мочь тоже мочь тоже мочь тоже мочь тоже	это место много 3ps приезжать путешествие <dact> почему это место2 много исторический clf музей разный
семья это много домашний работа	семья это много домашний работа	семья это много дом работать
но я никогда не встречать	нос ничто ничто не мочь нормально ничто ничто	1ps встречаться никогда
потому что нет общение нет любовь и понимание и он быть просто как собачка это очень страшно а у тот трое быть семья любовь общение и вот это реально до мурашки	потому что нет общение сильно сильно сильно сильно сильно сильно	общение ноль2 любовь ноль2 обнимать ноль2 игнорировать2 одинаковый собака2 clf clf.собака clf.прислушивается папа иса indx боль 3ps pl общение это 3ps pl 3ps pl спасибо общение делить думать сохранение понимать спасибо папа папа 3ps clf clf.мурашки clf.по clf.коже
в ноябрь будет год как я официально работать переводчик	носо русский беспокоящий год действительно русский русский русский русский	ноябрь официальный 1ps работать2 переводчик уже <nums> год
я ждать твой звонок но ты я не позвонить	я жевать ты я не мочь мочь мочь мочь мочь мо	1ps ждать2 когда2 3ps звонить.по.телефону 1ps 2ps тоже 3ps звонить.по.телефону 1ps нет2
рядом с печень желчный пузырь который удерживать желчь до необходимый момент	есть желчь с печень додерживать желчь до необходимость желчь до необходимость	печень рядом <dact> <dact> clf clf.желчный clf.пузырь indx <dact> действие оставить нужно clf clf.желчь clf.убрать
лев лишь рассмеяться	прав лишь лишь расмияться	смеяться3 лев смеяться смеяться3
интересно	интерес интересов	интересный
я быстро получать обещать жилье но это быть маленький комнатка в коммуналка где сосед ввергать в шок при первый же встреча	я скоро примерывать сильно пример заводская сильно главный2 сильно	1ps быстрый получать дом это был маленький3 комната сосед pl квартира сосед pl все сумасшедший3 1ps взглянуть
осаня начинаться в конец октябрь в ноябрь или декабрь	осаня начинать в конец октябрь 2017 конец октябрь 2017 ко	всегда осень2 начинать октябрь последний3 ноябрь декабрь всегда изменить.направление
интересно так	так оставить интерес	интересный так
второй вариант частично да частично нет	вторая вариант частично слабый вариант чистить 2 плюс общий вариант чистить 2	второй половина да половина <dact> слабый
ничто из еда нет	ничто из ничто из испытывать из еда нет ни	еда indx pl ноль
я любить голубой цвет а мой сестра ненавидеть он	я любить голубий цвет а мочь	poss 1ps любить голубой цвет голубой poss 1ps сестра ненавидеть2
переводчик слушать речь и переводить на жестовый язык	переводчик слушать речь и переводить на жестовый язык	переводчик слушать 3ps речь 1ps 2ps 1ps рассказывать.на.ржя рассказывать переводить рассказывать переводить
если бы у мы в школа россия знать что глухой ребенок из семья глухой свободно говорить на жестовый язык и он учить бы переход с жестовый язык на русский то в школа бы привыкать обучать на жестовый и у ребенок быть бы грамотный русский язык	если говорить на жестовый язык действительно русский русский русский русский	что если б-ы poss 1ps россия площадь б-ы школа вокруг знать ребенок глухой семья глухой говорить на жестовом языке <dact> переезд школа б-ы привычка обучать2 жестовый язык поменять грамотность poss 3ps русский язык
веселый	веселый блиный плюс веселый	веселый
первый вариант принимать такой как быть	результатый вариант принимать такой пример indx вариант принимать такой пример indx так	первый принимать такой2 как есть
а если с реб нком в семья общаться при помощь устный речь а жестовый язык считать ненужный это не совсем CODA	если с родной дом семья общать при помощь а плюс семья	а если есть кто дети2 мама семья глухой ребёнок дети2 родиться слышащий говорить2 жестовый.язык не.нужно говорить2 беседовать poss 1ps кода indx нет indx
этот чувство доброта и любовь появляться в человек сам по себя	человек иметь чувство доброта испытывать этот сильнота испыт	чувство добрый любовь появляться человек автоматический согласие
когда я забеременеть то так же работать до последний а потом еще и на дом брать подработка	если я забенять тоже нормально русский плюс нормально нормально	когда2 1ps беременность 1ps работать до <dact> приближаться плюс дом получать pl работать
как становиться эмоциональный энергичный воодушевлять свой жизнь	результат indx воодушевлять мой жизнь	как стоять эмоция энергия воодушевление свой жизнь как
год он лечиться и выздоравливать	год действительно и вызвать и выздоравливать и выздоравливать	год <nums> лечение заболеть здоровый
ты знать кто я	ты знать кто я знать кто знать кого я знать	2ps знать кто 1ps
также природа выделять жир роль запасной энергоноситель т е поступать жир пойти на образование энергия но только в случай крайний энергодефицит	результат indx слабый родной случай :5 :5 :5 :	успех и плюс природа 3ps давать 1ps электричество <dact> <dact> indx 3ps отправлять 1ps н-а основывать электричество только2 если 1ps электричество недоставать
заболевать	заболевание заболевание	заболеть
дедушка помогать антон они вместе записывать весь история семья	дедушка помощывать антон испытывать история семья	дедушка 1ps помогать 3ps <dact> вместе писать записать все история семья
на это мероприятие приглашаться весь дама и королева который хотеть повеселиться и отдыхать вместе со я принц это королевство сын король и наследник престол	что надеяться это испытывать это испытник испытник и	это мероприятие праздник приглашать все девочка кто мечтать желание веселиться отдых 1ps вместе 3ps 1ps принц руководить это территория сын король наследство дать 1ps престол
дотащить он мешок в лес и раздавать подарок весь животное они очень обрадоваться	уже группа доставать подарок вчера уже сильно сильно сильно	clf clf.принести indx лес и подарок pl каждый животное2 подарок все возбуждение
на концерт	на концерт на концерт на концерт на концерт на концерт на концерт на концерт на концерт на концерт на	зал
он лежать мертвый в высокий трава и в сердце у он быть острый шип	есть тело лежать мертвый сильно сильно сильно сильно сильно	о-н смерть трава clf clf.птица clf.упала clf.в clf.траву сердце птица2 indx был острый шип
женщина любить носить шуба они тоже защищать от ветер	indx любить носить шуба и тоже защищать от ветер	женщина pl любить носить шуба2 тоже включать ветер защита
снег растаивать потому что выглядывать солнце	снег выливать потому что выдыхать потому что выращивать солнце выращива	снег таять почему солнце
этот конкурс следующий конкурс увидеть принимать участие	результат indx конкурс наблюдать принимать участие	indx соревнование следующий соревнование заметить3 это 2ps стараться принимать участие
если вы решать участвовать в конкурс быть бы хорошо если бы у вы уже быть готовый проект потому что так легко будет о н м рассказывать доказывать он нужность	если вы решать что indx трудно дети трудно дети трудно дети трудно дети	что любой соревнование принимающий участие желание б-ы проект все готовый легкий принимающий участие проект есть легкий принимающий участие 1ps рассказывать 2ps доказывать легкий
этот организация только для слышать ребенок CODA	: : говорить ребенок плюс множественный слышать ребенок	indx это организация только <dact> дети2 слышащий кода
но помнить что масло бывать опасный	но запомнить что масло бывать опасный	н-о помнить что если масло бывает это опасный
грубый	грубый грубый грубый грубый грубый грубый	грубый
раз ты просить я подождать	ты прозывать я подождать я подождать я подождать	2ps просить 1ps ждать
наш сми за вс в то число и за размещение публикация хотеть получать деньги	мы сменять то число и захватывать деньги за вс семья indx 	у 1ps pl <dact> желание деньги нужда публиковать новости так ведомый деньги
самостоятельно выбирать ответ пожалуйста	профессионал вызывать ответ моля	сам2 нажать отвечать пожалуйста
благодаря сплоченность весь команда они выигрывать	благодаря сплоченныйность вчера 2013 2017 год выигрывать команда и выигры	спасибо команда дружба 3ps pl найти
и слышать и глухой приходить и организовывать свой группа	и глубоко обнимать и глубоко мир и глубоко мир и	приходить pl слышащий толпа группа pl свой группа глухой
опытный	опытный опытный опытный опытный опытный опытный	опытный
вс весь пока	всь пока всь пока всь пока	все пока
ждать ваш звонок	ждать ваш звонок	ждать2 ваш звонить.по.видеосвязи
крепкий	крепкий крепкий крепкий крепкий крепкий крепкий крепкий крепкий крепкий креп	твердый
например здесь в россия мы открывать свой организация код но мы выбирать русскоязычный название слышать ребенок в семья глухой	есть группа вызывать родной организация 1ps : 3ps : 3ps : 3ps	пример 1ps здесь россия 1ps создавать2 кода а факт2 clf clf.появиться называть <dact> poss 3ps россия 1ps называть слышащий слышать дети2 семья глухой
еще бывать по-другому при полный блокада дыхательный путь ситуация тяжелый человек не мочь говорить кашлять и дышать т е полный тишина	что мочь говорить по-другому при полный дыхательное путь е	еще по-другому если полный indx останавливаться это тяжелый человек говорить не.мочь.сделать кашлять2 не мочь дышать не мочь 1ps молчать тихий
я быть сильно тосковать когда ты не становиться	я сильно тосковать нормально главный сильно сильно сильно сильно	отвечать 1ps будет очень сильный скучать без вы
ставить лайк и деваться этот видео если оно ты понравиться	если ставить лайк ставить лайк и девать видео если	ставить.лайк и делиться это видео если 2ps нравиться
я повезти что проект быть выполнять давно	я поставлять что проект действительно давно сильно	1ps повезло и проект давно был выполнять
кто не видеть это видео в описание будет ссылка на это он и ссылка на плейлист урок остеопатия там вы находить очень много полезный и интересный	кто кто видеть это нормально главный плюс плюс плюс плюс	кто когда2 видеть не видео2 будет indx копировать копировать о писать <dact> это урок <dact> мочь видеть и мочь успех кто интересный множественный очень полезный
нечего дом сидеть с малыш я сам справляться а ты быть прибегать и кормить он	ребенок испытывать с родной дом семья indx и кормить а	бесплатный прохлада хватит 1ps сам2 ребенок 2ps будет приходить и кормить ребенок
специальность быть весь тот же программирование	специальность действовать весь веке специальность действовать множественный передавать весь	п-о специальность то.же.самое направление компьютер
только сам без мой подсказка	: : : : : : : : :	н-о сам2 без poss 1ps подсказывать
этот процесс нарастать и человек у который быть килограмм лишний начинать набирать вес ещ быстро словно из воздух	человек называть вес и человек усердный начинать сильно	успех у 3ps человек это есть лишний вес пример <nums> к-г лишний успех еще больше pl похоже ничего3 похоже больше pl успех
в нет год быть школа грантовый проектирование да	есть год действительно 2017 год действительно 2017 год действительно 2017 год действительно 2017 год действ	<nums> ш школа г проект п проект да indx
у мой брат нет жена	у мочь сестра нет жена	poss 1ps брат жена нет2
начинать учить жестовый язык	начинать учить жестовый язык	начать учить3 жестовый язык
и я непонятно почему вдруг опять чихнуть изо весь сила с какой-то даже подвывание чихнуть вот так апчхи уу	я чие подводная сила чие щипать изо вчера сила	1ps новый 1ps зачем не понимать 1ps <dact> <dact>
зима здесь очень холодно особенно в январь начало февраль	зима здесь нормально главный уже группа особенно 1ps : :	зима очень заморозить январь февраль срок.между
но получаться так что я глухой я же не смочь быть педагог	indx я не мочь2 я глубоко мир2 я глубоко мир2	успех вот 1ps глухой преподавание не.мочь 1ps преподавание
и улучшать углеводный обмен а именно чувствительность рецептор клетка инсулин они снижать аппетит и тяга к сладкий поэтому вечерний капсула рекомендоваться принимать за минута до еда	поэтому уже группа принимать зуб на сахарный тесто тестостерон	еще лучше2 <dact> clf clf.организм clf.процесс и чувство <dact> клетка2 <dact> indx ниже еда еще сладкий не.хотеть2 вечер капсула2 советовать з-а <nums> минута до будет еда
мы с вы рано не встречаться	мы срано не встретить это рано не мочь	мы.вдвоем раньше встречаться был не был
так сейчас	так сейчас так сейчас так сейчас так сейчас так сейчас так сейчас так	сейчас
там уже быть показываться другой новость	indx уже уже уже уже уже уже уже уже уже	другой новость clf clf.новость clf.подниматься уже
и тогда ваш жизнь обязателньо будет счастливый	и тоже мочь держать ответствень плюс плюс семья плюс семь	даже poss 2ps жизнь будет обязательный счастье
я не нравиться этот футболка то быть я не быть она покупать	я не мочь это нормально главный футболка не мочь я не мо	1ps футболка не нравиться тоже покупать не будет
наказывать	наказывать наказывать	наказание
следующий одинаковый мировоззрение и восприятие мир	последовательно одинаковый мировоззрение и восприятие мировой мировой мировой	следующий2 мировоззрение восприятие думать мнение pl о мир2 у.всех.одинаково
быть момент когда я нужно быть находить музей и я обращаться к наставник а они находить нужный человек и обменять мы номер	я обращать кто главный человек и обменять мы и обменять	1ps недоставать 1ps обратиться пожалуйста искать <dact> был 1ps искать нужно это 1ps обратиться пожалуйста <dact> успех 3ps хороший 3ps искать успех и обмен poss 3ps clf clf.сводить clf.людей
а кролик сидеть в мешок переживать вспоминать хороший время как играть с мальчик и общаться с лощадь	аник сидеть вчера с родной дом семь и общий год действительно	indx <dact> clf clf.куча кролик переживать помнить был хорошо время мальчик беседовать игра indx лошадь был общаться
какой причина	результат indx такая причина	причина какой
привет я звать мир	привет я звать мир	приветствовать 1ps имя <dact>
этот механизм будет работать только если мы взять грамм белок грамм жир из жировой запас и грамм глюкоза из гликоген	если мы взять грамма плюс грамма плюс грамма плюс плюс	успех <dact> <nums> грамм indx <dact> <dact> и-з <dact> выбирать
и чем	и чем и чем и чем и чем и чем и чем	<dact>
у я нет никакой одежда	я нет никакий одежда	1ps одежда2 нет3 нет2
здесь пособие не выдавать	здесь пособие не издавать пособие indx не издавать пособие	пособие деньги 1ps помогать 3ps давать 1ps нет2
твердый	твердый родной дом семья держать твердый	твердый2
мочь быть у вы другой причина я не знать у весь по свой	мочь не знать улица я не знать улица	мочь быть у 2ps pl другой причина indx не.знать2 свой pl
тихий	ты похороны ты похороны	тихий
нога муж лечить несколько месяц а потом он вернуться домой к нормальный жизнь	нога муж вернять несколько месяцев нормально главный дом семья вернять несколько	indx 1ps исправлять 3ps некоторый месяц а проходить о-н возвращаться домой к обычный жизнь
он постучаться в последний дом и прокричать впускать отдыхать дорожный человек	есть тоже мочь вчера начало проверкачать вчера 1ps :приглашени	indx последний смотреть стучать2 кричать выпуск дорога2 человек отдых
мы приезжать сюда с цель увидеть храм	мы приезжать с града с цель наблюдать скала	1ps приезжать зачем что видеть церковь <dact> дворец
если вы сомневаться нужно или не нужно то хорошо добавлять бальзам ничто страшный не будет	если вы сомневательное ничто добавлять нормально главный плюс плохо	если вы сомневаться необходимость не.нужно улучшать <dact> добавлять можно страх не иметь
я можно находить в Instagram во вконтакте	я исключать в Instagram во вконтакте	можно находить 1ps instagram indx можно вконтакте 1ps
мокрый	мокрый мокрый мокрый мокрый мокрый мокрый	мокрый
мы брать разный проект к пример взять один проект и заплатить человек взять второй и третий заплатить тоже	мы брать разный проект испытывать 2 плюс 2 плюс 2 плюс	проект другой получать pl indx пример indx проект indx зарплата 1ps 3ps человек indx зарплата 1ps 3ps indx зарплата 1ps 3ps
весь что у вы в жизнь происходить будет меняться	результат indx что уменьшать менять нормально	все что у 2ps pl случай pl жизнь будет изменить
в год весь немного поутихнуть и решать проводить II съезд глухой	результат indx решать проспектива и решать	<nums> год чуть-чуть успокоить и <nums> год желание проводить второй форум второй форум желание проводить clf clf.люди clf.собираются clf.в clf.одном clf.месте н-о indx <dact> indx
мой друг захотеть перечитывать сказка владимир григорьевич сутеев	мотеать перечитать сказка владимир григариевич сутеев	poss 1ps друг желание читать дизайн <dact> <dact> <dact>
я должный уметь побеждать в война	я должный умный умный умный ум	1ps обязанность качественный стратегия что война победа
там рассматривать мой проект спрашивать чем помогать и помогать я стараться участвовать в любой соревнование в новосибирск и другой город буквально в любой	есть мочь я старать нормальносибирск испытывать мочь я стар	clf clf.рассматривать clf.проект что нужно 1ps просить перечислять 1ps давать 2ps стараться любой соревнование что здесь новосибирск традиция город некоторый тоже традиция это indx соревнование успех принимающий участие
если месяц назад то на самоизоляция а если месяц или тогда как	если месяц 2017 год действительно если месяц действительно если месяц действительно если	<nums> месяц раньше <nums> месяц т-о самоизоляция если месяц <nums> месяц 3 <dact>
когда льдина уже почти растаивать он увидеть в вода деревянный бочка	где валина уже почти расти каждый сильно	когда быстрый таять clf clf.льдина таять медведь замечать вода indx деревянный бочка clf clf.бочка clf.плывет
например нужно или нет учить характер общение с ребенок	если необходимость родной дом семья или нет учить тип русский учить возраст	например характер общаться с ребенок необходимость не.нужно
поэтому должный быть отдельный факультет для тот кто хотеть продолжать качественно учиться с переводчик	поэтому уже группа желание что нормально главный факультет квалифицировать	поэтому должен быть отдельный <dact> 3ps кто желание продолжать качественный clf clf.человек clf.приходить переводчик преподавание переводчик indx
семья это счастие любовь и удача	семья это счастие любить и удача	семья это счастье любить счастье удача
видео мы отправлять несколько человек давать он весь посмотреть	мы доставлять несколько человек вчера посмотреть несколько человек давать несколько человек да	видео отправлять.сообщение pl все просить смотреть смотреть2
когда в школа глухой работать переводчик то они согласный приходить	где в школа глубоко работать переводчик то ими согласный призывать переводчик	школа глухой работать есть переводчик 1ps приходить гап
наш настроение легко портиться из-за политика из-за другой ситуация отношение	мы портить из-за ситуация окружающая средь за портиться из-за мир	мы очень легко грустить влиять 1ps страдать политика другой случай pl
на сегодняшний форум проблема со связь	сегодняшний форум проблема сопоставлять мочь	здесь сегодня <dact> проблема2 интернет связь
не столько я себя плохо чувствовать сколько хотеть оставаться дом и никто не видеть	я чувствовать дом и никто плохо нормально нормально нормально	1ps н-е только2 чувствовать плохо.себя.чувствовать плюс 1ps не хотеть никто видеть
если у вы появляться ещ вопрос писать мы в комментарий под видео	если у вы появлять ещ вопрос писать мы вчера 1ps : говорить	или случай ещё есть вопрос писать комментарии
а за остальной деньги куда пойти	а заблокировать а за все деньги а за все а за все	а indx нужно <nums> успех <nums> еще деньги clf clf.много clf clf.деньги куда
понимать нужно делать шаг для это развитие а не то как вы требовать давать и далеко сидеть сложа рука	есть тоже мочь плюс сильно сильно дети трудно желание что indx	шаг pl <dact> необходимость <dact> это развитие понимать 2ps желание требовать <dact>
отставать	посоливать отставать	отстать
ваш обычный еда не мочь так как я виноград гилберт	есть мочь я виноград гилберт плюс гадать плюс га	еда обычный простой все4 не мочь это 1ps виноград <dact>
она посмотреть вверх и увидеть красивый голубой небо и облако	есть замечать красота и облако	clf clf.посмотреть clf.вверх красивый <dact> небо голубой и <dact> clf clf.облако clf.pl
из москва	Москва из Москва из москва	и-з москва
умный	умный умный умный умный умный умный умный умный умный ум	умный
если она не давать то она начинать гавкать	если говорить если если если говорить гавкать гавка	если давать 3ps 1ps 3ps гавканье
и тот быть тоже быть ехать грязный рука	италия испытывать грязный рука	еда грязный
белый и зеленый чай зеленый кофе содержать природный кофеин который повышать влияние адреналин на жировой ткань в результат гореть наш жир	белый издря содержать природный кофеин повышать природный кофеин	белый2 зеленый <dact> зеленый <dact> составлять природа давать <dact> это давать энергия увеличение <dact> <dact> ткань получаться poss 2ps <dact> огонь
можно еще кондиционер в вид пена он легкий сглаживать волос и придавать легкий увлажнение	если соль испытывать волосы испытывать плавание плюс	можно <dact> <dact> пена легко clf clf.сглаживать clf clf.волосы легко увлажнение
опыт помогать я чувствовать себя уверенный в себя	профессионал помогать себя уверенный в себя уверенный в себя уверен	indx 1ps чувствовать себя уверенный
ну да давать премия вс правильно	ну давать премия вс нормально	премия 3ps давать 1ps
терпимость это то что сегодня так не хватать	терпеть так оставить нормально главный2 нормально главный2 нормально глав	терпимость это сегодня нужно pl
май самый т плый весенний месяц	хуже самый тять весенний месяц	<dact> всегда теплота в.течение весна теплота
всего-навсего студент	всего-навсего-навсего студент всего-навсего студент всего-нав	маловажный хз2 студент2
в полдень студент распахнуть окно и выглядывать в сад	студент распахнуть окно и выдуманный окно окно	день <nums> день студент2 открытый окно открытый видеть
осень ребенок надевать штаны сапог куртка и брать зонтик	осень ребенок возвращать штаны сапога Куртка и брать карты	осень дети одеться брюки сапоги куртка зонт <dact>
луиза очень привязываться к девочка но удерживать она не мочь не иметь право	луша придерживать к девочка но мочь не мочь поведение 1ps :	<dact> учить сильный любить девочка н-о держать не мочь нет3 право
антон пылесосить ковер и выкидывать мусор а дедушка например помогать бабушка и заниматься внук учить антон играть в шахматы а катя читать е любимый сказка	антон читать костер испытывать мусор испытывать костер	<dact> пылесосить плоский <dact> выкидывать пример дедушка 1ps помогать 3ps бабушка2 заниматься <dact> если трудно обучать2 <dact> обучать2 шахматы <dact> читать любить сказка
двигаться в правильный направление в пищевод это называться пищевой желоб	результатый путь называть пищевий направление	clf clf.двигаться направление правильный еда жевать2 внутренний <dact> назвать еда <dact>
хотеть немного подробно вы рассказывать чтобы кто-то быть полезный	что indx кто-то так оставить не мочь не мочь не мочь не	немного желание подробный рассказывать открытый изучать все быть полезный
я уметь красиво писать	я умить красото писать	1ps красивый написать мочь2
на поляна нет гриб	напольная зона нет гриб	территория гриб нет2
разрушать	нарушать разрушать	разрушение2
однако встречаться различный проблема и непонятно как двигаться далеко	результат indx не мочь поэтому нормально главный проблема и не мочь поэтому	дальше тупик pl как
если сдерживаться невозможно у вы быть пара минута чтобы добегать до туалет и расслабляться	если сдерживать пара минута что indx не мочь усердный плюс мо	сжатый не.мочь clf clf.чуть минута.две минута.три давать что до туалет бег2 место все4
но ты спас я жизнь	но ты спасать я жизнь	н-о 2ps спасать poss 1ps жизнь
тот же фамилия и у бабушка с дедушка ведь она переходить папа от они	что жевать папа отъезд 2001 2005 2009 2009 2009 2009 2009 2009 2009 2009 2009 2009 2009	одинаковый фамилия бабушка2 дедушка poss 3ps родители папа потому что папа передать 3ps передать 1ps фамилия свой родители
я тоже хотеть носить красивый платье	я тоже носить красотый платье	1ps тоже желание носить платье красивый
поэтому запасаться полезный продукт и поехать	поэтому уже фирма запасать полезный продукт и поэтому и поэтому	это собирать2 подготовка собирать2 и начинать
ну весь золушка теперь ты мочь ехать во дворец	ты мочь во дворец испытывать во дворец	все сейчас <dact> 2ps мочь уезжать дворец
очень мало человек заниматься программирование	уже много человек занимать программа	программирование дефицит <nums> человек все2
также плохой труба и канализация где протекать плохой вода и из кран так же бежать плохой и ржавый вода	что мочь труба плохой труба плохой труба плохой труб	это плохой вода труба <dact> clf clf.течь clf.из clf.крана грязный ржавчина труба pl плохой <dact>
я нравиться общаться с людьмиб интересно узнавать что случаться	я любить общийб интересовать все нормально главный с человек я люб	1ps pl нравиться общаться человек интересный узнать случай что
весь время они играть и гулять вместе как друг мальчик заболевать	результат indx играть иглалять весь время иглалять нормально главный	вместе pl игра гулять разнообразный вместе pl вдруг 2ps мальчик болезнь
бывать что катя и антон ссориться но потом обязательно мириться	indx дети трудно мириться но нормально мириться нормально мириться нормально мириться	<dact> <dact> быть pl ссориться быть pl н-о потом обязанность мириться
когда человек начинать кашлять хвататься за горло что мы должный сделать как должный помогать	где человек начинать кашлять хватать за горло что начинать нормально глав	человек начать кашлять2 задыхаться2 кашлять2 что мы должен 1ps помогать 3ps какой должен был
этот чай работать как антиоксидант бороться с некоторый процесс в организм	есть чай работать главный процесс вчера 1ps : : 3ps : 3ps 	<dact> indx работать2 как <dact> как против организм что есть
он слушать когда говорить и понимать	где слушать и слушать и слушать и слушать и слуша	3ps слушать говорить2 indx понятый
главное чтобы он действительно представлять то как бы он хотеть чтобы быть	главный2 что indx действительно представлять тоже мочь2 чёбы трудно	главный 3ps должен представить3 <dact> 3ps желание что был
второй совсем не принимать	вторая сопоставлять сопоставлять сопоставлять сопоставлять сопоставлять сопостав	следующий3 второй совсем взять не
они часто приходить на берег и плавать прыгать в вода	ние часто призывать прыгать ведро и платить ведро и плат	двое часто приходить clf clf.берег плавание clf clf.с clf.берега clf.прыгать clf.в clf.воду
я любить красный помада	я любить красный помада	губная помада 1ps любить красный
я не хотеть выступать на концерт	я не мочь концертать на концерт	концерт сцена принимающий участие не.хотеть
без вы у я на сердце тоска	обезьяна на сердце тоска на сердце тоскать без выскать вырез	без 2ps сердце чувствовать грусть
желчь	желчь желчь желчь желчь желчь желчь желчь желчь желчь жел	<dact>
давать разбираться зачем мы есть	мы давать знать зачем мы есть знать зачем мы есть знать зачем	пробовать исследовать почему мы еда почему
привет друг я звать андрей	приятель звать андрей	привет друг pl 1ps имя а-й
каков причина этот проблема у глухой	результат indx следствие этот проблема у глубокой	проблема2 глухой indx причина какой
старуха удивляться	старушка удивлять удивление	удивление старый
достоинстно	достоинстно достоинстно достоинстно достоинстно достоинстно достоинстно	гордость
сейчас я заниматься инскусственный интеллект т е то как он распознавать жестовый язык и переводить он в текст такой вот у я тема	я распознавать жестовый язык и переводить русский плюс жестовый язык	indx тема2 какой это <dact> какой это <dact> <dact> это для2 poss 3ps <dact> говорить на жестовом языке 3ps воспринимать 1ps говорить на жестовом языке 3ps воспринимать 1ps переключаться написать использовать искусственный.интеллект внутри тема2
переходить к тема	переходить к тема	clf clf.отодвинуть тема2
счастливый	счастливый роднойый дом семья	счастливый
каков причина	результат indx так оставить глава	причина2 pl какой
пожалуйста научать жестовый язык	пожалуйста научать жестовый язык	пожалуйста <nums> учить3 1ps мочь2 школа пожалуйста жестовый язык
и на розовый куст на самый верхний побег начало распускаться великолепный роза	самый верхний побег на самый верхний побег на самый верхний по	кусты розовый цветок кусты clf clf.побег clf.растения начинать clf clf.распускается clf.цветок красивый шикарный цветок
если быть учитель наставник то продвижение быстрый будет потому что ты учить и сопровождать да	если если если шить русский плюс продвигать русский плюс	быстрый будет карьера indx опыт есть 3ps учить 1ps 1ps заместитель да
вопрос такой вы уже переболеть	результат indx выболять вопрос такой выболевать вопрос такая выболевать вопрос так	вопрос 3ps 1ps заболеть уже
если бы я не становиться переводчик я заниматься бы продажа быть бы экономист	если если если я не мочь переводчик плюс деньги если	если 1ps переводчик нет2 б-ы был продажа экономика2
аплодисменты	обезьяна аплодисменты	аплодисменты
бывать низко температура	если бывать низко температура	ниже быть <nums> ниже
главное смотреть на то как выглядеть волос и что вы нужно на каждый день	главный смотреть на тоже мочь2 беседовать2 беседовать2	главный вы смотреть чувствовать clf clf.волосы clf.тяжелые что вы необходимость каждый день
далеко договариваться с государство а оно просить взятка	электрика договаривать с государство аемое проповедовать взятие плюс	следующий пример государство 1ps pl договор государство беседовать взятка
как пить капсула фуд контрол	что пить капсула фуд контролировать капсула фуд контролировать капсул	как таблетка <dact> <dact> как
при пережевывание еда распадаться на кусочек чтобы организм быть легко нужный слюна она смешиваться с еда и расщеплять она	при пережевывание едавать поличным слюна плюс переезд 2001 2005	когда2 жевать2 еда clf clf.распадаться clf.кусок что организм легко2 нужно <dact> clf clf.смаковать еда жевать2 исчезать
весь крепко и крепко прижиматься соловей к шип и песня он звучать весь громко и громко ибо он петь о зарождение страсть в душа мужчина и девушка	что надеяться о зарождение сильное сильное сильное сильно	птица2 clf clf.прижиматься clf.телом clf.к clf.шипу песня кричать птица2 это о-н песня о появляться эмоция все включено мужчина2 и девочка
я хотеть выступать на концерт	я желаемый концертать на концерт	1ps желание принимающий участие концерт
почему выбирать это число	поэтому поэтому потому что вызывать это число	число выбрать почему
в концертный зал кто-то быть	концертный зал кто-то шить в концертный зал кто-то кто	концерт зал <dact> кто есть indx
лето расти вкусный яблоко	лето расти вкусный яблоко расти вкусный яблоко расти вкус	лето расти вкусный яблоко clf clf.есть clf.яблоки
вот значит ствол дерево это возникать проблема нужно узнавать каков е причина и какой оказываться последствие	вот значить проблема необходимость дерево возникать проблема возникать проблема возни	indx indx дерево clf clf.ствол clf.дерева indx проблема2 indx причина <nums> что какой pl indx результат итог
они предлагать такой рабочий место куда человек с инвалидность не мочь устраиваться	ни предлагать такая рабочий центр где есть такая рабочий центр	3ps предлагать такой работа место куда инвалид вступить просто не.мочь
они уничтожать танк противник с то чтобы обеспечивать дальнейший продвижение пехота	они уничтожать танк с тоже мочь	танк уничтовать что clf clf.люди двигаться
мой мама ой мой папа закаляться не знать каждый день чтобы не заболевать обливаться хлодный вода ну знать стоять под холодный душ	сын учить каждый день сильно сильно	poss1 мама poss1 папа <dact> не знать каждый день что болезнь нет clf clf.обиваться холодно не знать душ
пока	пока пока пока пока пока пока пока пока пока пока пока пока пока пока пока пока пока пока пока	прощаться
трудный	трудный трудный трудный трудный трудный трудный трудный трудный трудный труд	трудный
я часто слушать история на ваш канал и теперь решать поделиться свой	я сильно слушать история	часто слушать история poss 2ps программа и решать разделение 1ps делиться 3ps собственный
в итог никакой поступление энергия нет	результат indx никакий поступление энергия нет	и ждать2 электричество тратить успех тоже нет2 запас
рубль нет даайт посмотреть что туда входить	рубль нет давать посмотреть что туда входить туда входить туда в	<nums> рубль не <nums> рубль нейтр.имп смотреть входить.во.что-то что
я тоже понимать что уже не мочь без он	я тоже знать что уже нормально уже нормально уже нормально	1ps сам2 думать что без 3ps 1ps не мочь
поэтому она открывать страница в Instagram о рыжий кот где рассказывать история о бобо который недавно выходить на пенсия	поэтому уже фирма открытная страниц вчера вызывать история о бобо	поэтому рыжий кошка3 <dact> открывать instagram2 страница рассказывать история <dact> 3ps совсем недавно уже выходить пенсия
если не получаться то во время реанимация инородный тело оно пройти в один из бронх и тогда один из легкий смочь дышать дыхание будет частичный не в полный объем	если не мочь дыхание дали все сильно дышать дыхание	если получаться нет т-о в-о время реанимация может.быть поперхнуться бронхи <dact> clf clf.инородное clf.тело clf.сдвинуться удача <nums> легкое удача пустой будет дышать н-е полный н-о часть будет
крепко прижиматься ко я милый соловушка не то день прийти рано чем заалеть роза	indx слабый придерживать ко рано главный соловушка не мочь приглашени	clf clf.тело дорогой птица2 если день начинать заранее красный изменять не.успевать
он не уметь кататься на лыжа	мы не знать лыжа	о-н мальчик 3ps не мочь не знать кататься.на.лыжах
и вот мы сыграть свадьба и я переезжать к он у они быть три комната в квартира	: : : 3ps : : : : : :	вместе свадьба 1ps переезд у 3ps indx все включено квартира у 3ps был <nums> комната pl clf clf.комнаты
мочь быть будет кто-то с кохлеарный имлант	мочь мочь кто-то с кохулыт кто-то с ко	может быть кто есть к-и кохлеарный.имплант
обязательно быть ошибка а расчет примерный	обязательно должен делать ошибка расчет примерный расчет примерный расчет пример	должен ошибка pl clf clf.уровень clf.разный примерно сравнить пример рассказывать
раздражать этот бесконечный ветер	раздражать этот бесконечный ветер	раздражать всегда ветер раздражать
чтобы не заболевать я делать зарядка	что indx не болезнь не заболевать зарядка	что болезнь нет 1ps делать зарядка2
кролик обращаться а я рано не быть настоящий	я обращать а я рано рано рано рано рано	кролик обратиться indx раньше2 не.был настоящий не.был
лето можно играть в песочница лепить кулич из песок	лето плюс играть в песок из песок из песок из песок.	лето мочь игра песок делать пирожок pl делать песок
я самый трусливый и самый слабый из весь животное	я самый трусливый и самый трусливый я сам	1ps самый3 трус и самый3 слабый2 и-з животное pl
главный задача угвеод обеспечивать мы быстрый энергия во-первых белок и жир организм усваивать в определенный количество а угвеода приниматься в любой количество	главный инженер усваивать мы чистый процент а плюс 2 процент плюс 2	<dact> это 3ps давать 1ps быстрый электричество почему пример <dact> <dact> это внутри.себя воспринимать точно сколько 1ps нужно лишний не.нужно воспринимать а <dact> все любой получать pl воспринимать
он ездить на автобус	мы ездить на автобус	о-н ехать.на.транспорте автобус автобус
если у вы волос торчать то и вы хотеть они сглаживать то нужно использовать коллаген шелк кератин и белок	если у выглаживать коллаген шлаген и белок плюс	если у 2ps pl волосы clf clf.волосы clf.торчат clf clf.волосы clf.торчат желание clf clf.сглаживать что что необходимость использовать <dact> <dact> <dact> <dact>
живот сообщать мозг и он понимать ой да да да где здесь туалет	человек изучать мозг испытывать мозг испытывать мозг и	живот indx сообщение 1ps мозг возникать понимать да pl тулет искать
тема будет очень интересный о переводчик какой он должный быть какой качество должный обладать и т д	есть сильно сильно сильно сильно сильно сильно сильно сильно сильно	тема2 интересный о человек2 переводчик какой должен был какой качественный какой правила2 что пример список2 исследовать будет
потому что когда вы начинать делать что-то в ущерб себя вы начинать ненавидеть тот для кто это делать	потому что вы начинать что нормально главный ущень сильно сильно	например 1ps себе заставлять3 pl похоже 1ps начинать человек pl ненавидеть2
он встряхиваться отчего мышонок упасть на земля	есть так оставить на земля	трястись2 мышь2 падать2 н-а земля
и давать направление действительно нужно развивать	и давать направление действительно плюс действительно плюс действительно действительно действ	и это направление действительно нужно развивать
я премия не давать	я премия не давать вал	премия давать 1ps не был
чуть в легкий не попадать	хуже indx не попадать в легкий не попадать воздушний не попадать в	indx clf clf.чуть легкие попал clf clf.чуть
вот например весь знать проблема глухой работа и т д	вот шить проблема глубоко мир испытывать проблема глубоко мир и	1ps пример проблема2 глухой все самый знать проблема2 работать перечислять2
нужно делать шаг	есть необходимость шаг делать шаг	необходимость шаг pl
сжимание стенка называться перистальтика	сжимание стена называть перистальтика	clf clf.стенки clf.пищевода clf.сжиматься назвать <dact>
а человек заложник потом отпускать	человек за отпускать а человек за отпускать а человек отпускать а человек отпуск	брать.за.руку уводить да
сразу невозможно быть получать	стоимость не мочь делать получать	indx <nums> любой толпа получать не.мочь.сделать
в трудовой ресурс зарплата такой же как в материальный	трудовой республика зарплата такой жевать пример завод зарплата такой женой	зарплата труд тоже indx мочь ждать
мой брат не любить шоколад с то момент как отравляться он	мочь сестра не любить шоколад с тоже мочь	когда2 3ps poss <nums> брат яд шоколад после2 это не.любить шоколад
я весь этот три день участвовать рассказывать защищать свой проект сказать что у я уже быть письмо поддержка например от музей балл быстро подсчитывать и это быть успех	я вчера изучать рассказывать русский плюс успех успех что indx трудно	день <nums> это indx 1ps делать 1ps рассказывать 2ps защищать 3ps финал защищать 1ps рассказывать 2ps что 1ps indx <dact> есть 3ps поддерживать 1ps печать indx спонсор все есть известный быстрый <dact> и 1ps успех
смотреть группа из человек это мало человек это много	группа смотреть группа из человек это трудно человек это трудно человек это трудно человек это трудно	смотреть indx <nums> человек группа <nums> человек мало <nums> человек множество толпа
урок называться наш дружный семья	урок называть нас дружный семья	урок назвать poss 1ps pl дружба семья
кто там в новосибирск быть	кто таможить в новосибирск indx ть плюс новосибирск indx ть плюс новосибирск	кто indx indx новосибирск есть
а проблема то в то что мы мочь говорить на жестовый один рука а в англия человек так не мочь	тоже мочь говорить на жестовый рука а мочь говорить на жест	indx проблема2 indx англия жест только2 fs clf clf.использовать clf.обе clf.руки два говорить на жестовом языке рука один говорить на жестовом языке мочь2 телефон говорить на жестовом языке мочь2 англия нет3
ну если ничто нет давать варить каша из топор	если ничто нет давать каша из топор	н-у если ничего нет2 нейтр.имп. пробовать готовить <dact> и-з топор2
первый раз укусить начинать жевать	результатый раз укорачивать начинать	когда2 первый clf clf.укусить начать жевать2
температура то повышаться то понижаться снег мочь то неделя лежать а мочь мало и потом растаивать	есть тоже мочь тоже мочь тоже мочь тоже мочь тоже	температура повышать быть понижать clf clf.толстый clf.слой <dact> <nums> неделя мочь меньше таять
главный дед мороз удивленно посмотреть на он и сказать теперь ты быть не маленький дед мороз а лесной	есть главный дед мороз удивный дед мороз удивный дед мороз indx удивный дед мороз indx	дед.мороз видеть главный видеть удивление дать был <dact> дед.мороз поменять <dact> что лес точно
медвежонок ларсить жить на северный полюс вместе с мама и папа	попугай ларвать жить на северный полюсный полюсный полюсный	медведь имя <dact> жизнь место clf clf.шар indx северный вместе родители
в это дом не бывать гость	есть дом семья не мочь гость	это дом гость ноль
ошибка считать что можно похудеть быть принимать капсула лежать на диван и ходить по тысяча шаг в день каждый день увеличивать это количество на шаг	что уже группа принимать капсула плюс капсула плюс	все думать лекарство лежать лекарство уже <nums> тысяч <dact> ходить нужно каждый день увеличивать <nums> ходить увеличивать
пожалуйста выбирать то кто по ваш мнение входить в сообщество глухой	кто вызывать то кого по мочь мнение вчера 1ps : 3ps pr	пожалуйста выбрать pl поставить.галочку выбрать poss 2ps мнение что включать мир2 глухой
весь спрашивать почему на юг так популярный одежда защищать от ветер	поэтому спрашивать поэтому уже спрашивать поэтому уже спрашивать	все спрашивать 1ps ю-г популярный clf clf.толстая clf.одежда защита ветер
я в близкий время хотеть сделать опрос о то кто желать становиться глухой экскурсовод экскурсовод для глухой	я вчера 1ps : 3ps :принести глубоко мирный плюс глу	1ps будет опрос 3ps pl кто желание переводчик глухой <dact> проводить кто желание есть желание
проходить день неделя а она весь мечтать	проходить дне неделя аемое дне неделя аемое дне неделя а	желание проходить день проходить неделя
ясный	ясный ясный ясный ясный ясный ясный ясный ясный ясный яс	яркий солнце светлый
да он мастер форма это у он отнимать нельзя но быть ли у он чувство	indx дети трудно желание что дети трудно плюс плюс плюс плюс	да 3ps мастер песня голос2 качественный н-о интересный у 3ps чувствовать общий есть нет2
у они бюджет быть от сто двести тысяча и высоко	ничто вести уже русский вести тысяча плюс тысяча	3ps финансирование2 о-т <nums> тысяча pl и выше
в инкубатор быть свой плюс ты давать помещение оказывать финансовый и юридический помощь оборудование техника много что давать	ты давать плавание плюс плюс плюс плюс плюс плюс плюс	это <dact> попадать indx <dact> плюс pl что 3ps давать 2ps комната2 мочь 3ps давать 2ps бухгалтерия юрист помощь множественный что 1ps давать 2ps мочь механизм компьютер
ладно сам доносить	нормально сам нормально сам доносить нормально главный доносить нормально	пусть сам2 clf clf.нести clf.на clf.плече
маша не спать весь ночь она готовиться к экзамен	маша не спать весь ночь не спать весь ночь не спать	<dact> н-е спать не все нет с утра до вечера ночь 3ps подготовка экзамен
в магазин быть сыр	в магазинбыть сыр	магазин <dact> магазин есть
очень много глухой готовый заниматься л гкие дело	сильно глубоко мирный готовить л гкий дело	человек много человек pl так будет делать хуже дело
но с ветер конечно по-другому	но с ветер нормально с ветер нормально с ветер нормально с ветер нормально с ветер	ветер случай другой будет
гаснуть	царь гасить гаснуть	clf clf.свет clf.выключить
энергия давать позитивный мышление и жизненный тонус	электрика давать позитивный мышь давать позитивный мышь и жизненный то	энергия давать 1ps мысль плюс pl и жизнь возбуждение
но это мой жизнь	но это мочь жизнь но это мочь жизнь но это мочь жизнь	это 1ps жизнь
если я король то ты очень храбрый принц это лес	если я король тоже мочь вольные улицать лесть лесной	если 1ps король т-о 2ps очень смелый <dact> лес2
эхо понести этот трель к свой багряный пещера в гора и разбудить спать там пастух	эвакуированный пещера вчера 1ps : понести этот трель к мо	приветствовать clf clf.эхо clf.распространяется гора clf clf.эхо clf.распространяется звук clf clf.эхо clf.распространяется кто пастух indx спать слышать просыпаться
в результат слышать ребенок не давать жестовый язык	результат слышащий ребенок не давать жестовый язык	какой это н-е давать нет слышащий дети2 жестовый.язык
как это из топор можно сваривать каша	что из топор плюс сваривать каша	как <dact> и-з топор2 мочь готовить вопрос
животное встречаться влюбляться с первый взгляд подружиться и помогать друг друг выздоравливать	человек подружчать с родной взгляд подружчать с родной взгляд подруж	такой встреча <nums> 3ps 3ps животное2 <dact> влюбиться первый взгляд.друг.на.друга дружба друг.друга помогать 3ps 1ps pl здоровый
быть тот кто смотреть и говорить ну это же так просто и легко не смотреть	кто смотреть нормально главный плюс плюс плюс плюс плюс	мочь кто смотреть н-у простой легко2 все4 поэтому кто смотреть не.нужно
нечестный	нечестный нечестный нечестный нечестный нечестный нечестный не	честный нет
рано он называться иср а сейчас название новый истый	рано называть иср а сейчас называть иср а сейчас на	раньше был <dact> сейчас3 новый <dact>
фрукт уже практически нет	фрукт уже уже степень уже  практика уже  практика уже	плод pl мало уже
весь ребенок начинать изучать жестовый язык	результат indx подросток начинать изучать жестовый язык	ребенок уже начать задавать.вопросы жестовый язык
вдалеке увидеть деревня	вдалеке видеть деревня	смотреть деревня далеко3
сам смотреть что вы надо что не надо	сам смотреть что indx трудно желание что трудно дети трудно желание что трудно	сам2 смотреть как нужно что poss 2ps pl что не.нужно
и он высовываться из окно и сорвать она	испытывать из окно испытывать из окно испыт	студент2 clf clf.высовывать clf.голову clf.из clf.окна окно clf clf.высовываться clf.из clf.окна срывать clf clf.держать clf.цветок clf.в clf.руке
она быть такой же злой и вредный	indx шить такой женой женой женой женой женой женой женой	характер такой.же злость вред
вы так беседовать со свой ребенок	вы так беседовать со свой ребенок	тоже 2ps pl беседовать собственность дети2
делать нужно в определенный модификация	что необходимость необходимость необходимость необходимость модификация делать необходимость в определённый мод	н-о только2 делать в странный мода
следующий человек потерять слух во взрослый возраст	последовательно человек потерять слух во взрослый возраст	следующий2 человек pl кто оглохнуть взрослый
например первый это грант	есть  пример завод шить плюс вторый это грант	пример первый <dact>
мальчик ловить и крупный рыба	ребенок ловить и крупный рыба	мальчик ловить великий рыба2
первый это хлопок по спина	результатый это хлопок по спина	первый 1ps нужно спина clf clf.человек clf.выбить clf.инородное clf.тело
как сделать я	что сделать я	как делать 1ps
работа в команда похожий на профессиональный спорт	профессионал похожий на профессионалый спорт	indx и почему 1ps говорить объяснять команда indx такой профессионал спорт
здравствовать	здравствовать здравствовать	здравствуйте
на этот земля не расти ни кукуруза ни картошка	что ни расти ни кукуруза ни расти ни ку	земля территория расти <dact> картофель расти не мочь
что мы нужно сделать	что мы необходимость образование трудно делать что мы необходимость делать2 делать	что мы нужно делать
я быть делиться свой опыт	я так оставить свой опыт	1ps свой опыт будет 1ps делить советовать рассказ кто 3ps pl жестовый.язык
друг	приятель ненавидеть страна	друг
а у старушка весь быть	а у старушка старушка весь быть а у старушка весь	3ps у 3ps старый все есть
наслаждение	наслаждение на наслаждение	наслаждаться
я любить сосиска	я любить сосиска	1ps сосиски 1ps любить
ветер здесь до м с	ветер здесь доить до м срок срок срок срок срок с	ветер до <nums> м секунда
нужно изменять себя внутри переставать заставлять себя и жертвовать себя	есть сильность себя вчера 1ps : зафиксированный себя вчера 1ps	нужно внутри.себя изменять себе заставлять3 нет2 отдавать.себя нет2
необходимо привозить оборудование который предоставлять электричество	необходимость привозить техника который предоставлять электричество	необходимость собственность clf clf.взять clf.привезти оборудование электричество деньги clf clf.взять clf.привезти необходимость доставка
ругать	ругать ругать ругать ругать ругать ругать ругать ругать ругать ру	ругать2
падать снег и быть темно	падать снег и быть темно и темнота	идет снег был ночь
грубый	грубый грубый грубый грубый грубый грубый	грубый
слышать всегда смотреть на то какой вы команда если сильный вы быть работать	что выдуманный всегда нормально главный выдуманный всегда нормально главный	слышащий 3ps pl видеть команда какой 3ps команда сильный будет делать
получаться столбец не связанный слабо связанный средне связанный сильно связанный	что родной домбец не мочь столбец не мочь столбец не	получать2 clf 4.столбца первый здесь связать пустой так.себе связать норма нет2 столбец связать есть н-о так.себе слабый связать есть средний связать крепкий
попадать	похищать попадать	попасть clf clf.что
я начинать этот занимать в год и обучение там длиться день с утро до самый вечер	я начинать этот самый год действительно сильно	1ps начинать был <nums> indx день <nums> учиться с утра до вечера учиться
и он вернуться к себя в комната вытаскивать большой запылить книга и приниматься она читать	испытывать большая запылить больший запылить больший запылить	студент2 обратимый домой комната собственный книга clf clf.книга clf.большая clf.тяжелая протирать <dact> протирать и clf clf.открыть clf.книгу начинать взглянуть читать
отношение быть меняться	отношение действительно делать менять менять менять менять менять менять	отношения изменять будет
можно ли в ваш регион подписывать соглашен о трудоустройство человек с инвалидность в другой организация	есть плюс родной оглашение что мочь соглашение мочь соглашени	можно л-и poss 2ps регион подпись <dact> о трудоустройство инвалид другой организация
он никогда не быть в турция	indx ничто не мочь в Турция ничто ничто ничто	3ps никогда2 турция не был
или если у вы быть знакомый который знать финский жестовый язык передавать он этот информация пожалуйста	если у вы шить финский язык передавать финский или молярный язык действ	или у есть знакомый 3ps знать жестовый.язык2 финляндия 2ps передавать пост2 видеть отправлять пожалуйста
подымать	подымать подымать	clf clf.поднимать
я видеть что вокруг много молодой человек школьник который не думать куда поступать а думать куда пойти они друг или куда направлять они родитель	я видеть что вчера дети трудно дети трудно желание	так 1ps замечать вокруг много молодой и школа думать 1ps куда поступать брать.пример.с друг родители 3ps заставлять2 1ps
у третьяков быть хобби он быть меценат и оплачивать строительство школа для глухой ребенок выделять целый тысяча на это и в год построить трехэтажный здание школа	третьяк издавать плавание да	и <dact> 3ps <nums> дело хобби 3ps деньги финансирование забота семья школа для глухой <nums> тысяч отправить з-а строить clf clf.здание строить <nums> год этаж <nums> здание
тамара долго идти по почти непролазный дорога и вдруг увидеть дым из труба один из дом она обрадоваться побежать подавать и весь грязный добираться наконец до это дом	есть таможня продвигать испытывать дым из труба2 грязный	ходить медленно место дорога был неприятный стремный н-о глаз indx дом дым и видеть бежать2 падать2 плакать тело грязь добраться до это indx дом
мы радоваться когда гладить котенок и чужой слово влиять на наш настроение	мы радовать котенок и чужий язык действовать нормально главный плюс род	когда2 мы радоваться радоваться что видеть например кот indx что гладить2 слово чужой сказать 1ps влиять 1ps настроение
хм а кто же будет кучер	хм кто жевать кучер хм кто жевать кучер	задуматься кто 3ps будет кучер
там быть мой кворки нажимать создавать кворк	есть мочь создавать кворк нажимать кворк нажимать кворк на	indx <dact> <dact> indx строка создать <dact>
смотреть как он обучать что нужно добавлять	что обучать что необходимость образование добавлять что необходимость что необходимость образование добавлять что	<dact> clf clf.человек обучать2 что необходимость добавить
мой отец бояться мачеха	мы отец бояться мачеха	poss 1ps папа мама второй бояться3 бояться
к сожаление фотография прабабушка и прадедушка родитель бабушка и дедушка не сохраняться поэтому на это дерево весь начинаться с бабушка и дедушка	попугай не сохранять это дерево и дедушка и дедушка и дед	сожаление фотокамера <dact> дедушка <dact> бабушка2 отсутствие 3ps родители 3ps бабушка2 дедушка отсутствие сохранять отсутствие поэтому indx дерево все начать бабушка2 и дедушка
ну в общий это вс что я хотеть сказать	ни в общий это все что я трудно желание что я трудно	все результат 1ps желание сказать
это желание будет помогать копить	есть желание что желание помощь копченный копченный желание	это желание 1ps помогать 1ps копить будет
ленивый	ленивый ленивый ленивый ленивый ленивый ленивый	ленивый2
муравьед любить кушать насекомое авокадо цитрусовый	муравьед любить насекомые авокадо авокадо родкомые	3ps еда <dact>- паук <dact> апельсин <dact> еда обожать2
зато рейтинг высокий и много заказ а у он все заказ быть отзыв	indx фирма испытывать плюс 100 плюс 50 процент плюс 10 процент	3ps высший р-е- заказ pl много у 3ps <nums> 3ps заказ быть pl <dact>
когда у маленький дед мороз весь подарок быть готовый остальной вс думать что снова надо будет ехать дарить ребенок подарок возвращаться домой что это очень скучно	где учиться родной дом семья возвращать дом семья indx сильно	3ps подарок похоже готово clf clf.коробки clf.расставить готово это ждать все дед.мороз неинтересно опять2 не.хотеть ехать.поездом дети подарок pl назад домой не.хотеть похоже неинтересно поэтому думать обсудить пусть
еще раз хотеть сказать что каждый момент свой жизнь нужно наполнять радость	что каждый человек наполнять радость на наполнять радость что каждый день трудно	еще раз хотеть сказать каждый момент свой жизнь нужно наполнять радость
костик и мишка сказать тоже где ты быть что с ты приключаться рассказывать	ты так оставить тоже мочь и мишка сказать что с ты искупать	еще <dact> <dact> 3ps спрашивать 1ps тоже где был случай что 2ps рассказывать 1ps
семен по путь с работа забирать дочка из садик и к ужин они всегда быть дом но не в этот злосчастный день	indx так оставить дочка из садик испытный дом семья indx не мо	<dact> работать clf clf.человек clf.идет 1ps забирать 3ps дочь и-з дети <dact> и вечер всегда2 домой еда стол н-о попадать день беда
и по свисток начинать собирать человек на съезд в москва начинаться беготня в общий постанавливать собирать человек в москва в июль год	Москва начинать собрание июль год действий постанавливать человек в июль	и свистеть начинать clf clf.люди clf.собираются clf.в clf.одном clf.месте съезд москва попал беготня общий постановить clf clf.люди clf.приходят москва <dact> <nums> год2 <dact> clf clf.люди clf.приходят
как жираф	что главный жираф	жираф похоже
смотреть результат быть	результат смотреть результат indx смотреть результат indx смотреть результат indx смотреть результат indx смотреть	смотреть иметь результат
краудфандинг	царьфандинг	<dact>
когда вы себя насиловать унижать у вы нет уважение к себя вы не в состояние что-то давать	если вы себя не мочь восприятие 1ps : 3ps : 3ps :	похоже отдавать.себя себе унижение себе уважать 1ps нет2 похоже 1ps не мочь давать pl
однажды они зайти в лесной глушь	ни за искать в лесной глушь	вдруг лес внутри
мама он сразу начало учить я жизнь что я должный муж беспрекословно во весь слушаться и сразу выполнять весь что он требовать	что надеяться что я выполнять я главный2 я выполнять2	мама poss 3ps начинать 3ps учить2 1ps <dact> жизнь что 1ps муж должен был послушный2 3ps заказывать 1ps 3ps приказать 1ps 3ps требовать 1ps 1ps выполнить
я работать уже давно с начало создание адаптиса	я работать уже давно с начало создавать уже давно с начал	1ps стаж2 давно все4 работать2 когда начинать создавать2 sn
без знание жестовый язык этот ребенок не являться CODA	результат indx знание жестовый язык не мочь	жестовый.язык не.знать считать2 н-е кода нет 3ps
нордис в г новосибирск	норисс в г новосибирск в г новосибирск в г новосибирск в г новосибирск	<dact> новосибирск здесь
благодаря плодоножка вишня в организм не накапливаться лишний жидкость а в жировой ткань активизироваться процесс микроциркуляция	благодаря не называть лишний жидкость жидкость жидкость жидкость	еще clf clf.плодоножка indx indx н-е 3ps давать 1ps добавлять жидкий лишний внутри.себя и активный промежуток.времени управлять <dact> внутри.себя ткань
они поехать в приют и предлагать вместе с они собака пойти на долгий прогулка	ищет ищет на долгий прогулка покидать ведро прогул	<dact> поехать место <dact> и нейтр.имп вместе собака poss 3ps забирать и гулять долго
я вс учитывать и тогда я получать удовольствие от работа потому что она быть в кайф	я всучить удовольствие отъезд 2001 2005 2009 2009 2009 2009 2009 2009 2009 2009	1ps все считать2 и 3ps pl удовольствие 1ps работать почему indx кайф3
вообще весь человек журналист ленивый	результат indx ленивый человек ленивый человек ленивый человек ленивый человек	все журналист все человек pl ленивый все
я удаваться оформлять кредит благодаря то что в банк к мой проблема относиться с понимание	я удалять банк к мочь понимание относительно сильно проблема относительно	1ps мочь2 оформлять кредит почему благодаря понимать 1ps есть проблема2
готовый	готовый готовый готовый	готовый
потом няня становиться жалко кролик но доктор сказать надо сжигать и давать новый	няня сказать жалко кролик indx так оставить нормально главный кролик	потом 2ps няня2 смотреть жаль врач2 спрашивать доктор2 indx кролик indx так огонь новый давать
но вы сам понимать что связь у я не так много но то не менее шанс уже быть у вы быть шанс получать помощь	indx так оставить2 шанс indx плюс шанс indx плюс шанс indx 	н-о у 1ps понимать2 зависеть мало временный есть 2ps pl <dact> есть радость 2ps спрашивать 1ps
и плюс всегда развиваться учиться идти вперед	плюс все плюс все плюс все плюс все плюс все плюс все	и плюс всегда развитие учиться идти.вперед
и если милиция я не находить	если милиция я не называть милиция испытывать милиция и	вдруг indx милиция 1ps 1ps искать 3ps успех нет
спонсор готовый платить я выполнять проект в это город нехватать мыло я сообщать спонсор получать мыло и раздавать	попугай готовить мочь я выполнять мыло и раздавать мыло	платить2 согласие постоянный платить2 1ps проект выполнять сдать pl город indx не.хватать 1ps объявлять 3ps clf clf.взять clf.мыло сдать pl
сейчас глухой начинать активно заниматься индивидуальный предпринимательство и это плюс потому что они становиться независимый	результат indx глубоко мир начинать нормально главный плюс плюс плюс плюс	все и-п мочь indx плюс потому что свой зависимость не
они наблюдать и чувствовать что необходимо создавать общество для ребенок CODA	и наблюдать что необходимость общество для ребенок плюс ребенок	смотреть pl чувствовать что нужно создавать2 общество группа для кода
либо где можно находить спонсор чтобы получаться сокращать количество деньги и расход быть по ноль	где шить2 деньги плюс деньги плюс деньги плюс деньги	или где можно находить спонсор что составлять получаться деньги кратко расходы ничего
кто-то печ т торт кто-то фотографировать работать в такси и развивать автопарк кто-то заниматься ремонт	кто-то фотографировать автопарк кто-то-то-то-то-	кто торт печь кто фотография2 достигать кто такси подготовка автомобиль <dact> развитие кто ремонт
я очень рад что быть выбор профессия специальность	я сильно благодарить выбор специальность	1ps очень радостный есть выбор профессия специальность
она помогать она заниматься научать готовить печь шить они часто вместе гулять ходить в музей и на выставка	есть уже группа помощать готовить печь шить2 шить2 шить	помощь учиться 1ps учить2 3ps готовить пирожки пирог шить вместе часто прогулка музей выставка смотреть2
также от до процент калорийность идти на пищеварение	также от до год калорийность идти на пищеварение	еще о-т <nums> до <nums> процент <dact> мы тратить н-а пищеварение
многий из они еще и работать переводчик в вуз	indx уже работать переводчик или русский русский русский русский русский	и 3ps pl переводчик много посетить <dact> переводить работать посещать.и.то.и.это
встреча	есть встретить встрева	встретить
я говорить что нужно сюда а он в другой место доставлять	я говорить что необходимость аемое аённый город вчера 1ps 	1ps не 1ps indx доставка 3ps 1ps 3ps не indx
гость ничто не купить к чай	гостиь ничто купить к чай	гость pl ничего3 деньги не <dact> чай indx
это он собака	это уже собака	это poss 3ps собака
да да постоянно калька	да : да : да	да да калька2 pl
я состоять в ассоциация слышать гид	я собрать васса слышащий гид слышащий гид	1ps есть включать содружество <dact> проводить <dact> слышащий включать
дом красиво украшаться весь делать друг друг подарок вместе играть и танцевать	дом семья украшать весь и танцевать	дом красивый украшать все делать подарок подарок2 все семья игра танцевать
мы отда м себя полностью и жд м любовь к себя	мы издавать мять мять мять мять мять	отдавать.себя pl ждать2 любить себе
важный использовать бальзам если волос повреждать и торчать	если важный использовать и торчать и торчать и торчать	бывает clf clf.волосы clf.торчат получаться clf clf.волосы clf.повреждены волосы clf clf.волосы clf.повреждены получается clf clf.волосы clf.повреждены сломанный clf clf.волосы clf.торчат получаться
не ловко ну да ладно	ловко ловко ловко ловко ловко ловко	неудобно2 ладно
как это на жестовый передавать	что так оставить на жестовый передавать	жест как передавать
солдат посолить и снова попробовать	студент посолить и снова попробовать и русский попробовать и	солдат немного солить новый пробовать
ведь это самый настоящий кошмар	сам2 clf где есть самый настоящий настоящий настоящий настоящ	страшный будет
допускать к вы приш л пациент со свой проблема и вы выяснять что у он быть психосоматический влияние	indx вызывать к выгоду л человек сопоставлять к выгодущее время мочь	случай пример человек clf clf.человек clf.приближается у 3ps есть проблема2 3ps видеть что у 3ps есть мозг <dact>
выделять деньги на школа	есть вылять деньги на школа	школа clf clf.выделять clf.деньги
когда вы чувствовать себя хорошо и человек вокруг вы чувствовать себя хорошо уровень жизнь качественно поменяться	где вы чувствовать себя нормально главный нормально главный2 нормально глав	1ps хорошо 1ps делать для 3ps pl <dact> себе приятный все себе чувствовать хорошо жизнь уровень изменять
давать поговорить по душа	по душа давать поговорить по душа душа	нейтр.имп. общаться душа
у он быть одежда	мы жевать одежда	одежда2 нет одежда2 у 3ps есть
на следующий день они вдвоем встречаться с орел	результат indx группа ведроем встретить с орализованный день гари ведроем	следующий день двое встреча орел встреча
я из семья глухой мой мама и папа глухой	я из семья глубоко мир и глухой родной дом семья глухой	1ps семья глухой poss 1ps мама папа глухой
спрашивать у лощадь как быть всегда вместе с мальчик	есть всегда спрашивать улицать всегда сильно	обратиться мальчик вместе indx нет
когда быть просить мало деньги то и грант вы легко давать	где есть просить много деньги то деньги плюс деньги плюс деньги	<dact> деньги мало просить деньги мало грант легко
находить	нахождение на ходить нахождение	находить
састье слышать	састье слышащий састье слышащий састье слыш	счастье слышать
говорить	говорить говорить на говорить	говорить
вога кормить себя плюс еще инвалид кормить	подводная кормить себя плюс плюс плюс плюс плюс плюс	indx <dact> себя 1ps кормить 1ps плюс еще инвалид кормить 3ps
когда знать что быть резерв на душа спокойно а когда потратиться переживать лишний раз вдруг увольнять	где знать что действительно душа нормально сильно увольнять сильно у	знать копить indx 1ps на.душе.спокойно 1ps выбросить переживать вдруг уволить думать лишний
я всерьез это никогда не воспринимать но когда увидеть он возмужать взрослый почувствовать как защемлять сердце	я всерьезовать не мочь воспринимать сердце	1ps <dact> серьезно воспринимать нет и видеть сегодня2 взрослый 1ps нравиться
мужчина схватывать чемодан в один рука сумка в другой и на ход потому что поезд уже начинать медленно ехать вскакивать на ступенька	человек схватывать чемоданный ступняк indx схватывать чемоданный ступ	мужчина2 взять <dact> clf clf.сумка clf.взять сумка clf clf.бежать что поезд начать clf поезд ехать и clf clf.человек clf.прыгнуть ступенька
деньги я не давать но выписывать рекомендательный письмо письмо поддержка начальство поставлять печать	результат indx деньги поставлять печать	1ps согласиться письмо поддерживать согласиться заполнять администратор печать качественный clf clf.держать clf.письмо clf.в clf.руке хорошо
в конец июнь начало июль уже созревать вишня черешня абрикос	черепаха уже созревать вишня черепаха уже созревать вишня чере	clf clf.плод clf.pl готовый последний3 июнь начинать июль indx вишня <dact> <dact>
сахар в кровь расти а вслед за этот расти и количество инсулин	сахар вчера сахар вчера сахар расти и количество инсулин	сахар в красный увеличивать множественный и плюс множественный <dact> добавлять pl
не то чтобы он не хотеть я слушать но просто он вс это быть безразлично	indx не мочь я слушать но все нормально главный2 все нормально глав	мальчик н-е только не хотеть 1ps слушать тоже 3ps безразличие
он думать лишь о музыка а всякий знать что искусство эгоистично	если говорить лишь о музыка а о музыка а сильность	3ps думать только2 о музыка все знать искусство indx только2 думать о себя pl
а ефросинья петровна надо я видно просыпаться от это грохот	а ефрасина просыпчать отрезина нормально я нормально	<dact> <dact> открыть.глаза
можно делать сковоречник	если делать сковоречник плюс сковоречник делать сковор	мочь делать дом для птица
когда реб нок чувствовать что он не один он начинать по-другому относиться к свой родитель открываться он	если человек чувствовать по-другому плюс не мочь по-другому	1ps <nums> нет 1ps чувствовать открытый и начать относиться папа п-о другой
очень довольный	уже сильно беспокоящий нормально нормально нормально нормально нормально нормально	очень довольно
за этот три год в инкубатор вы расти и становиться сильный но кроме этот пункт который я уже объяснять быть и другой способ получать деньги на свой проект	что дети трудно пример завод испытывать деньги на русский плюс русский	год <nums> выпускать2 <dact> родиться больше уже сильный выпускать2 это множественный мочь другой талантливый 2ps проект есть все включено делать карьера
я звать елена	я звать елена	здравствуйте 1ps имя <dact>
утом помогать запускать обмен вещество на максимальный скорость работа щитовидный железа давать прилив энергия и хороший настроение а вечер наоборот успокаивать настраивать на хороший сон и защищать от обжорство и ускорять расход жир из наш запас	результат indx дисциплина поддерживать приливый комплекс и защищать отрезченный	утро помогать 1ps clf clf.организм clf.процесс clf.начать максимум скорость clf clf.организм clf.процесс clf.работать работать2 щитовидная.железа ш clf clf.щитовидная clf clf.организм clf.процесс энергия clf clf.организм clf.процесс и настроение хорошо а вечер2 наоборот успокоить слабость спать хорошо защищать о-т еда pl нервный отсутствие <dact> тратить запас быстрый
ну вот же у ты готовый ответ	ни желание готовить ответ	готовый ответ
я заканчивать учиться пойти работать туда где быть глухой	я заканчивать учиться дисциплина где есть глубоко мирная дисциплина читься	1ps учиться конец поступать2 работать2 место глухой
вот	вот вот вот вот вот вот вот вот вот	здесь
потом я подзывать свой ребенок который знать жестовый язык он весело подходить ко я	заем я подзывать себя конец indx родной дом семья indx родной	потом ребенок poss 1ps ребенок нейтр.имп ребенок оживленный нейтр.имп 1ps жестовый язык знать clf clf.подойти нейтр.имп
начинать дуть ветер	начинать дуть ветер	ветер pl начинать
в холодильник нет еда	в холодильник нет еда	холодно indx еда нет2 ноль скелет2
что же делать	что жевать что же делать что же делать что же делать что же делать	что делать
ты бояться даже ветер	ты бояться даже ветер	2ps бояться даже ветер
в понедельник мы быть проводить прямой эфир	результат indx мы наблюдать прямой эфир	у 1ps будет понедельник завтра будет проводить п-э
Ещ дедушка с антон хотеть сделать семейный древо	щь сделать семейный древо	еще дедушка вместе <dact> желание делать дерево ветвь pl семья
семья это сложный но жить один невозможно	семья это трудно жить нормально жить нормально жить нормально жить	семья это сложный н-о счастье жить <nums> невозможный
конечно нужно чтобы кто-то вызывать скорый помощь	нормально нуждавать скорый помощь	конечно нужно чтобы кто заметить indx вызвать <nums>
тома находить в себя сила прощать муж хоть и даваться она это нелегко	есть тоже мочь мужья испытывать мужик испытывать сильно	<dact> успех себя сильный прощать2 мальчик муж действительно был тяжелый
работник китайский магазин в нью-йорк взять он в магазин и он оставаться там на год	профессионал взять это на нью-йорк взять это уже фирма	магазин нью-йорк китай магазин взять и оставить <nums> время
вечерний капсула пролонгировать лимфодренажный эффект получать на первый шаг	результатный капсула пролонгировать лимфодренатый капсула пролонгировать лимф	вечер капсула indx <dact> жидкий 1 <dact> был 3ps давать 1ps indx управлять clf clf.выравнивать
да вредить	давать вредить да	наносить.вред
борис джонсон болеть в март	джонсон болдеть вчера вчера джонсон болеть в март 2017	3ps <dact> <dact> заболеть был <dact>
сестра пойти на бал а я нет	сестра покидать на бал а я нет на блин я нет на	сестра двое уезжать бал 1ps не будет
в мой город нет аэропорт	мы нет аэропорт нет аэропорт	poss 1ps город аэропорт нет2
мочь быть я смочь взламывать сенсор ааа он на работа	мочь я взламывать сенсор а	мочь 1ps мочь сломать clf clf.сенсор clf clf.стучать 2ps работать2 занято
узкий	узкий узреть узкий узкий узкий узкий узкий узкий узкий уз	clf clf.тонкий
вот уже не думать что из топор такой вкусный каша мочь получаться	вот уже уже рано думать что из топор так оставить2 то	<dact> у-ж н-е думать не что и-з топор2 так хорошо <dact> мочь готовить
вс вокруг начинать зеленеть и цвести птица прилетать	вскружить птица прилетать птица прилетать птица при	все круговое движение начать зеленый начать цветы птица
а однажды в ателье зайти женщина в возраст она долго рассматривать я задавать вопрос а потом сказать что быть бы неплохо она сын познакомиться с такой девушка	indx заем сказать что indx трудно желание после плохо дети трудно желани	и вдруг 3ps входить 1ps женщина возраст и пристальный взгляд 3ps вопрос.задавать 1ps потом 3ps отвечать 1ps б-ы poss 3ps сын 1ps девочка соединять знакомить
девочка она не понравиться	ребенок не мочь	девочка мама смотреть не нравиться
в предыдущий видео мы говорить о то что мы потреблять слишком много разный вкусный еда но организм не мочь потратить весь этот энергия	indx видео говорить о мочь2 все уженый сильно	давно видео2 мы 1ps рассказывать 2ps что еда множественный еда некоторый вкусный а тратить indx электричество внутри.себя не мочь уже
легкий	тяжелий тяжелий	легко2
познакомиться я предлагать и я становиться заниматься резьба	познакомиться и я предлагать и я предлагать и я	знакомить 3ps предлагать 1ps 1ps заниматься резьба2 карьера
когда в первый раз участвовать совсем ничто не понятно	если вчера вчера вчера вчера вчера вчера вчера вчера в	раз <nums> куда не понимать первый второй третий
у крашеный волос цвет исчезать	у крашеный волос цвет исчезать у крашеный волос цвет исчезать	волосы что крашеный цвет3 исчезновение
давать ждать	давать ждать ждать ждать ждать ждать ждать ждать ждать ж	нейтр.имп ждать2
вопрос вводить ли свой ребенок в сообщество глухой приводить ли на праздник участвовать ли в мероприятие	глубоко приводить ли мочь во время глубоко мирный вал вал	вопрос 2ps свой дети 2ps включать мир2 глухой проводить мероприятие праздник участвовать
самый плохой что это в климат краснодарский край это ветер	самый плохой что это вчера вчера нормальной что это вчера	плохой крупный что indx климат краснодар территория ветер
спать далеко это я дениска	я сильно сильно сильно сильно сильно сильно сильно я	какой спать продолжать 1ps <dact> имя
я заходить в строка продавец туда заходить	я заходить в строка проповедовать в строка проповедовать в строка	1ps зайти строка продавец
рассказывать про человек про то как я здесь рождаться и про вс остальное	про человек прощать про человек про тоже мочь прощать про человек про тоже мо	будет о человек pl разнообразие 1ps здесь родить много разнообразие рассказывать будет
весь и у я быть удобный защитный средство	я шить широкий защитный комплексный плюс indx плюс плюс и	все4 и себя есть удобный защита прятать защита
весь другой животное очень взволноваться	результатный животной сильно взволновывать сильно	все другой животное pl очень волнение2
он просто оглушать я	indx оглушать я	слышать звук
после урок идти к ребята	после урок идти к ребёнок ребёнок ребёнок ребёнок реб	поздно урок приходить дети <dact>
так вот третьяков построить трехэтажный здание школа а рядом еще больница построить	если третьяк строить двуэтажный здание школа а центром еще 10	3ps т-у создавать2 этаж <nums> и больница2 был строить clf clf.расположение clf.объектов clf.в clf.пространстве
почему это слово код являться популярный во весь мир	поэтому слово кодировать популярный во все мирный мир	почему это слово <dact> популярный2 <nums> называть мир2
хорошо пока	результат пока пока пока пока пока пока пока пока пока пока пока пока пока пока пока пока пока пока	хорошо пока хорошо
мать обещание не сдерживать и после окончание школа оля уезжать в чужой город и там и оставаться	мать обещать испытывать сильно сильно обещание indx обеща	мама 3ps алкоголь и проходить школа <dact> уезжать другой чужой город и indx зафиксировать
к пример я экскурсовод кто не приходить человек так называть экскурсант	человек так называть экскурсант кто не призывать экскурсант кто так называть экскурс	представление 1ps <dact> clf clf.толпа clf.движется clf.loc 3ps имя называть <dact>
я под кровать за двадцатьлет не то что созревать я там вполне перезревать	я подчеркивать за многочестный я	1ps лежать <nums> время 1ps детство уже уже изменять взрослый будет
это федеральный государственный образовательный стандарт	есть федеральный республикаальный государственный образовательный образовательный образовательный образовательный	это poss 3ps государство печать наука, образование
я с она очень согласный	я с полный я с полный нормально нормально я с полный	1ps мнение согласие
можно слепить снеговик	если слепить снеговик плюс слепить снеговик плюс слепить	мочь делать <dact> шар pl
я думать что такой курс давать глухой новый возможность	я думать что глубоко  новосибирск  новосибирск  новосибирск  новосибирск	1ps думать что курс давать новый возможность для глухой
в-третьих это огромный количество энергия который обрушиваться на мы и мы не знать куда он потратить	мы не знать где есть сильно сильно сильно сильно сильно сильно	третий еще это большой clf clf.поступление clf.энергии электричество это множественный clf clf.поступление clf.энергии 1ps тратить куда трудно
мой учитель сказать женщина у она дочь со сломать позвоночник что это не причина отказываться от радость плакать не нужно	сын сказать не мочь позвоночник indx не мочь сопоставлять не мочь	мой учитель имя дактилирование 3ps был сказать у 3ps был дочь с позвоночник сломаться 3ps говорить это н-е причина н-е радоваться плакать не
в магазин нет сыр	магазин нет сырать сыр	магазин <dact> нет2
не предлагать я ехать	я предлагать я ехать я ехать я ехать	просить уважать 1ps 1ps предлагать 3ps еда не.нужно
общий представление о белок жир и углевод мы мочь получать в лаборатория однако у мы в организм весь устраивать намного интересный и сложный	мы мочь вчера 1ps : 3ps : 3ps : 3ps : 3ps 	это общий мочь получать только2 лаборатория poss 1ps внутри.себя все еще интересный и сложный
нет хорошо так мой подруга быстро бегать не уметь	что мочь не мочь не мочь не мочь не мочь не мочь не	не poss 1ps друг быстрый бежать не знать
утро принимать два капсула после еда вечер за минута до ужин	утро принимать 2 капсула после едавать плавание да	утро еда все4 clf clf.принять clf.две clf.капсулы вечер2 будет еда <dact> з-а <nums> минута будет еда
они бродить до утро по улица а потом поехать на вокзал и снова они место быть рядом	если если если если если если если если если	согласиться прогулка с.вечер.до.утро потом вместе clf clf.два clf.человека clf.идут вокзал2 и попадать место сосед
мы не смочь поймать рыба	мы не мочь поймать рыба	1ps рыба схватить не мочь
у я двое слышать ребенок	я двуе слышать ребенок	1ps у 1ps дети2 <nums> слышащий
мы вс восстанавливать	мы восстанавливать мы всстанавливать	не.переживать
давать подумать о то что вы написать	тоже мочь о тоже что выписать трудно о тоже мочь	поэтому нейтр.имп строчка pl думать
в магазин пойти	в магазин покидать в магазин пойти пойти в магазин пойти в магазин пойти	магазин пойти
они собираться и общаться на жестовый язык	испытывать и общий язык	3ps собираться проводить говорить.на.жестовом.языке
я только русский и английский язык	я только русский русский русский русский русский русский русский	1ps <nums> русский английский 2
следующий тот кто не знать жестовый язык	кто знать жестовый язык	следующий2 кто жест не знать
я быть в италия	я шить в италия	италия2 1ps был
саша сломать нога из-за это сегодня не прийти на день рождение	саша сломать нога из-за это уже с родной дом семья indx	<dact> <dact> сломанный это 3ps не мочь приезжать день.рождения clf clf.человек clf.прийти день.рождения
жизнь закалять и я благодарный весь кто поддерживать я в непростой время помогать подсказывать	человек поддерживать я вчера кто поддерживать и я вчера 1ps 	жизнь 3ps учить2 1ps 1ps благодарение все кто был сосед 3ps поддерживать 1ps 1ps тяжелый время 3ps подсказывать 1ps
да раз в неделя заниматься	indx раз:5 до год:3 до год:3 до год:3 до год:	indx неделя <nums> раз <nums> учиться
здравствовать	здравствовать здравствовать	приветствовать здравствуйте
я она слушаться потому что считать что она становиться я мама я она даже так называть	я слушать потому что мочь потому что мочь потому что мочь	1ps согласиться надеяться <dact> <dact> poss 1ps мама тоже 1ps иметь тема <dact>
еще когда человек полностью задыхаться мы останавливаться	где человек полностью задыхать мы останавливать мы останавливать мы	еще когда человек полный задыхаться2 останавливаться полный тихий
совсем отрицательно	сопоставлять сопоставление	следующий3 совсем отрицать
здесь мы также продолжать заниматься в различный кружок проводить тренинг и разнообразный мастер-класс	результат indx кружок проводить тренинг и различный кружок прощать тренинг	здесь тоже продолжать разнообразие кружок мастер класс <dact> разнообразие
либо родитель не отдавать все себя ребенок и не объяснять смысл слово на жестовый язык	:5 : говорить на жестовый язык действительно плюс жестовый язык действ	или родной отдавать.всего.себя говорить на жестовом языке рассказывать мысль слово
к сожаление не весь семья такой дружный	попугай так оставить семья не мочь родной дом семья не мочь род	сожаление все семья такой дружба
я не мочь ты отпускать поэтому я купить билет до твой город	я не мочь поэтому я купить билет доить это уже мочь	1ps 2ps свобода не мочь 1ps кормить билет до poss 2ps город
только вы так странно одевать	если вы так оставить нормально главный плюс плюс плюс плюс	одежда3 просматривать одежда3 странный
где-то или месяц	где-то или месяц	месяц <nums> месяц <nums> месяц <nums> месяц 3
вода в речка быть прозрачный так что можно быть увидеть камень на день	есть вода вчера изучать камень на чёрк-приблизнный камень на	вода река прозрачный видеть камень четко
у мы с другой быть секрет друг от друг	мы сдавать секрет на страна	1ps друг вдвоем секрет иметь делить ноль
у я в план в дальнейший объявлять о возможность проведень курс обучение	я вчера объявлять о взгляд на будущее республика о возможность реализ	у 1ps есть план 1ps уже ранее объявлять о poss 1ps план обучать2 <dact> обучать2
весь человек разный у весь разный работа и характер разный то что я объяснять это не готовый формула успех главное я давать вы правильный направление	что я делать выдуманный усердный усердный усердный усерд	человек pl разный работать2 разный характер разный поэтому 1ps объяснять это готовый2 успех все4 1ps выполнять главный направление правильный clf clf.двигаться clf.в clf.направлении
нужно что-то решать но я действительно не знать с что начинать	indx действительно знать с что трудно дети трудно решать	думать решать нужно действительно 1ps не.знать что с что начать
мы договариваться встречаться в определенный день я приходить рассказывать о свой проект и сказать что деньги пока на он нет	мы доить это о собственный день : 3ps indx изучать2	1ps договор число попадать 1ps <dact> приходить это встречаться 1ps разговаривать2 да согласие 1ps что проект 1ps есть а деньги временный нет2 1ps желание <dact> <dact> деньги зависеть
я не понимать математика	я не знать математика	математика 1ps не понимать нет3
неполный блокада дыхательный путь	про полный блокада дыхательный путь	н-е полный не останавливаться дышать
наверное вы подумать что быть лишний окошко	проколоть что indx лишний окошок	наверное думать еще лишний
настоящий	настоящий настоящий настоящий настоящий настоящий настоящий	настоящий
бабушка и дедушка родитель папа а мама и папа родитель катя и антон	папа испытывать катя и папа и папа и папа и папа	бабушка2 дедушка это родители папа poss 3ps мама папа родители poss 3ps <dact> <dact>
еще он замечать бабочка медвежонок никогда не видеть ничто такой же яркий разноцветный красивый и удивительный	уже ничто замечать ничто так оставить ничто так оставить	еще замечать бабочка2 раньше медведь видеть никогда похоже яркий цвет разный и красивый удивительный
весь животное в лес смеяться над мышонок	что весь животной окружной дом семья смеяться над мышонок	все животное pl лес2 смеяться угрожать2 <dact> мышь2
мелкий	мелкий  мелкий  мелкий  мелкий  мелкий  мелкий  мел	мелкий2
они связываться со спонсор который попросить предоставлять скидка или раздавать мыло бесплатно чтобы ребенок использовать он для мытье рука	ничатый прозывать скидка или нет общий плюс плюс мочь	уже контактировать pl <dact> спонсор контактировать pl просить 3ps скидка или бесплатный раздавать мыло сдать pl дети2 умыть руки использовать pl уже
следующий акселератор	последовательно акселератора последовательно акселератора	следущий3 <dact>
общий	общий плюс общий общий плюс общий плюс общий плюс общ	общий
мой попугай любить человек	мочь попугай попугай любить человек	poss попугай <dact> любить человек pl
акцентировать внимание именно на это	акцентировать внимание именно на это акцентировать внимание и	<nums> до у 1ps 1ps интерес акцентировать.внимание дети2
вот и первый рыбка ерш	вот испытенный рыбка ерш	первый рыба2 ловить <dact>
мой бабушка любить гулять ночь	мочь бабушка любить ночь ночь	poss бабушка любить гулять ночь
получаться что один апсула с утро уменьшать аппетит особенно тяга к сладкий защищать от развитие метаболический синдром инсулинорезистентность а в дальнейший сахарный диабет усиливать эффект насыщение и защищать от повторный набор вес	есть тоже мочь сильно сильно сильно сильно сильно сильно сильно	успех капсула утро indx уменьшать2 следующий3 еда еще не.хотеть отдельный2 сладкий indx желание нет2 и защищать о-т о-т воспринимать и сахар <dact> конец и сильный увеличивать чувствовать сытый и защищать о-т обратимый вес увеличивать
я обожать что в мой работа нет однообразие всегда разный место человек информация посещать разный мероприятие	я обожать разный человек общий маршрут	обожать2 что 1ps однообразно так нет2 всегда2 разный место человек pl информация разный посещать.туда.сюда разный
антон настоящий старший брат он всегда защищать свой маленький сестра если кто-то в школа иногда пытаться е обижать	антон защищать это сильноий родной дом семья сильно	<dact> настоящий старший брат 3ps всегда защита свой маленький сестра забота случай что школа быть pl 3ps кто обида дразнить
и я становиться интересно быть ли подобный в москва	я становить интересный Москва и русский плюс русский плюс русский	1ps интересный москва здесь есть отсутствие
человек не носить это платье потому что оно мало	человек носить это платье потому что носить это не носить это не мочь	человек pl н-е носить это платье почему это indx мало маленький3
здесь африка	здесь африка здать африка	здесь африка2
мочь быть чтобы деньги оставаться на потом но на самый дело весь человек разный и у каждый быть свой причина	мочь заемный деньги оставить нормально главный2 прошлый дело 2001	мочь быть что думать копить оставить желание н-о так 2ps pl человек pl разный причина свой pl внутрь
мучение	мучение мучение мучение мучение мучение мучение мучение мучение мучение му	страдание
тонкий	тонкий тонкий тонкий тонкий тонкий тонкий тонкий тонкий тонкий тон	худой2
да	да	да
в интернет быть список конкурс в свой город	интернет читать список конкурсировать список конкурс	интернет список соренование свой город
рано быть такой автомобиль красивый длинный с олень на капот	рано рано рано рано рано рано рано рано рано	<dact> раньше красивый clf clf.длинный clf.автомобиль clf clf.фары <dact> олень clf clf.олень clf.лапы clf clf.олень clf.стоит
она начало что-то говорить да неожиданно замолчать	indx начало что-то говорить да	3ps <dact> девочка рассказывать случай неожиданно2 молчать
несколько год назад у она к сожаление умирать мама	есть несколько год действовать несколько год действительно к сожаление смерть	несколько лет назад2 девочка poss 3ps мама смерть жалость
пожалуйста помогать мы кто если не вы	если помощать мы кто кто плюс не мочь	1ps просить 2ps помогать 2ps 1ps если 2ps кто дефицит
у мы весь переводчик первый категория и постоянно повышать свой квалификация	мы повышать это дисциплина сильно повышение дисциплина повышать мой	у 1ps переводчик все первый <dact> и всегда расти карьера учить карьера всегда
он быть старый я на год и наш отношение быть довольно странный	есть я называть старый я называть старый я называть старый	мальчик 3ps был старший 1ps н-а <nums> лет и взаимоотношения был странный
человек говорить не мочь но он модевать покачать голова	человек модевать порез голова	человек говорить не.мочь.сделать голова как голова кивать хорошо
невозможно	результат indx не мочь не мочь	невозможный
правильно	нормально нормально нормально нормально нормально нормально нормально нормально нормально	правильный
код собираться вперемешку	код собрать вперемешка	кода собрание смешанный
он так бояться	indx так бояться бояться	о-н так страх
я подумать у я получаться резьба заниматься	я придурок у я получать удача я получать удача я	поэтому 1ps думать резьба2 успех как
в будущее мир глухой исчезать или нет	будущее мир глубоко мир исчезать или нет	думать будущее мир2 глухой исчезновение будет или не.будет
это не мой тема но я смотреть немного в будущее	indx смотреть не мочь тема но : 3ps : 3ps : 3ps :	это н-е poss 1ps тема но 1ps смотреть чуть-чуть будущее
это прекрасный возможность для человек с различный ментальный заболевание кто действительно не мочь трудоустраиваться и он нужно постоянный сопровождение	человек действительно сильно сильность сильность сильность сильность сильно	это отличный возможность для человек pl разный pl умственный заболевание кто не мочь разделять не мочь трудоустройство 3ps нужно следующий следить
множество человек	множественный множественный множественный множественный множественный множественный	множественный человек pl
не понимать почему кушать что	поэтому уже кто изучать поэтому уже кто изучать поэтому	2ps не понимать почему еда что
похоже откусывать сэндвич	похоже откусывать сэндвичывать сэндвичывать сэндвичывать сэнд	похоже <dact> clf clf.сэндвич clf.откусить
и вот изображение стекло запотевать он начинать он протирать и когда протирать начинать проявляться картина то что он хотеть	:взять начинать и : начинать начинать и : 3ps	пример clf clf.изображение clf.размытое начинать вытирать когда2 вытирать появляться картина рисовать это соответствовать indx что 3ps желание похоже 1ps исправлять 3ps
также здесь рассказывать об история общество глухой о то откуда возникать жестовый язык	результат indx общество глубоко мирная возникать об история общество глубоко мир	и 3ps включать похоже 1ps рассказывать 2ps история раньше глухой общество жестовый.язык2 возникать
если не помогать снова производить хлопок пока ни получаться	если если если если если если если если если	бесполезный новый clf clf.человек clf.выбить clf.инородное clf.тело clf clf.человек clf.выбить clf.инородное clf.тело чередовать глаза clf clf.инородный clf.предмет clf.вытолкнуть нужно
когда медвежонок просыпаться папа не быть только вода повсюду	где просыпаться папа не мочь нормально главный нормально главный нормально	когда медведь маленький3 проснуться папа пусто повсюду вода
получаться при минимальный увеличение жир обмен вещество в организм замедляться в раз	при минимальный объем обеспечивать при минимальный объем2 обмен вещество вчера	получаться clf clf.чуть увеличение <dact> увеличение clf clf.чуть получаться clf clf.огранизм clf.процесс <dact> медленно в 1.5 <dact> медленно
я переводить различный пара мероприятие	я переводить различный пара мероприятие	1ps переводчик разный урок мероприятие
а к кто обращаться	а к кто обращать а к а к кто обращать	а обращаться кто
я обязанный знать военный дело	я обязанный знать военный дело	1ps обязанность знать правила военный дело
древолаз очень токсичный и бывать разный цветок желтый темно-зеленый красный черный но самый опасный золотой	сильно-зеленый сильно-сильно-сильно-белый сильно-зеленый	clf clf.лягушка clf.взбирается clf.по clf.дереву у 3ps есть вредить есть бывает видеть цвет3 желтый темный зеленый красный синий черный н-о сам2 опасный зеленый цвет3 золотой
вопрос кто входить в сообщество глухой	кто входить в сообщество глубоко мирной вопрос кто входить в сообщество	вопрос кто включать мир2 глухой внутри
четвертый ваш мнение	черетый выгоду мнение	четвертый poss 2ps мнение
веко защекотать слезинка когда поезд тронуться но вдруг дверь в купе открываться и входить роберт	что поезд называть слезинка и вчера робертка робертка	слеза поезд clf clf.поезд clf.трогается вдруг clf clf.двери clf.купе clf.открываются мальчик clf clf.человек clf.идет то.же.самое <dact>
создавать	создавать создавать создавать	собирать
а куст кричать соловей чтобы тот еще крепко прижиматься к шип	что а кусать к шипта	кусты clf clf.кусты кричать птица2 imp держать clf clf.тельце clf.птицы imp
мочь быть у вы быть какой-либо вопрос или хотеть подробность я готовый вы отвечать спрашивать	мочь мочь мочь мочь мочь мочь мочь мочь мочь мо	может.быть у ps2 есть вопрос подробный мочь ответ спросить 1ps
нападать	насекомые нападать нападать	напатать
из жир так же как и из белок строиться клетка оболочка мембрана без жир не образовываться поэтому часть жир идти на строительство этот мембрана и не давать мы энергия	что мочь часть мочь мочь мочь мочь мочь мочь мочь	<dact> indx и <dact> тоже строить клетки.организма indx без clf clf.оболочка clf.клетки это делать и-з <dact> это отдельный <dact> будет использовать строить clf clf.оболочка clf.клетки и электричество 3ps давать 1ps нет indx половина убирать
сделать такой ступенька на память красота	такая ступня сделать такой ступень на память красота	это indx ступенька был собирать памятник красивый
быть много направление где можно себя применять физкультура преподавание разный направление быть	спортивная преподавание изучать физкультура преподавание разный направление	1ps какой физкультура направление считать3 преподавание направление считать3 любой разнообразие3 куда все есть
а инвалид нужно быть обязательно давать путевка дом отдых специальный больница	результат indx группа давать путевка дом семья или плюс 2 степень	и а инвалид так нужно платить pl должен первый путевка отдых дать дом pl отдых дать специальность больница2
мой текущий рабочий деятельность мочь продолжаться до но вдруг я узнавать о болезнь или что-то случаться	мочь мочь мочь мочь мочь мочь мочь мочь мочь мо	сейчас 1ps деятельность работать2 быть хорошо мочь до <nums> мочь быть н-о узнать болезнь что случай
это значит настоящий поэтому сейчас он не мочь	indx так значить настоящий поэтому уже сильно	это настоящий сейчас не мочь
поэтому я хотя и оробеть но не до конец и весь продолжать посматривать на ефросинья петровна что же она будет делать далеко	поэтому уже группа желание что нормально сильно сильно сильно	1ps пока 1ps чуть-чуть страшный чуть-чуть взглянуть бабушка взглянуть делать что интересный взглянуть
по разный причина по сложный работа по ещ какой-то причина просто не хотеть	по разный чин indx не мочь по разный5 чин indx indx не мочь по	разнообразие причина сложный условие труд ещё что-то не.хотеть
в сентябрь обычно тоже жарко	сентябрь обычно тоже жарко	сентябрь indx тоже
внешний	внешний внешний внешний внешний внешний внешний в	внешний
я не знать испанский язык	я не знать испанский язык	1ps испания2 язык 1ps не знать
я относиться ко весь одинаково хорошо	я относиться конец indx нормально главный конец indx нормально главный	1ps все так хорошо отношение
один ребенок будет смотреть но он это не нужно	ребенок смотреть но indx смотреть но плюс не мочь смотреть но indx трудно	смотреть не.нужно
мой профессия интересный и необычный	мочь профессия интересный и невычный плюс и невычный	poss 1ps профессия переводчик интересный необычный
однажды тамара присниться сон забросить деревня а там дочка и она звать тамара и просить скоро она находить	множественный принести сон называть сомнение испытывать сон называть таможня	и однажды 3ps девочка сон изгой2 деревня и дочь кто кричать мама pl быстрый 1ps успех
в-третьих помимо углевод жир и белок пища давать наш организм витамин и минерал который регулировать различный процесс	результат indx чистить это игла чистить нормально главный процесс игла чист	третий еда <dact> <dact> <dact> вместе еще 3ps давать 1ps плюс полезный <dact> что метаболизм правильно работать внутри.себя все
я должный уметь командовать отряд	я должный умный умный умный умный ум	1ps нужно знать пример группа военный руководить
я часто пропускать школа из-за то что сидеть с младший сестра	я часто пропускать школа из-за тоже с младшей сестра	1ps часто прогуливать школа почему 1ps сидеть вместе младший сестра
общий	общий плюс общий общий плюс общий плюс общий плюс общ	общий2
что хотеть сказать	что трудно желание что трудно желание что трудно желание что трудно желани	желание сказать
бывать что в связь с погодный условие обледеневать и оборваться провод но опять же такой случаться редко	результат indx уженый условие обледеневать и оборывать все нормально глав	быть попадать <dact> мороз дождь быть clf clf.провод clf.pl провод clf clf.провод clf.порваться редко
так быть всегда сказать сова и это никогда не изменяться	так оставить всегда ничто indx не мочь вина : 3ps indx 	разговаривать2 <dact> пусть всегда ладно думать изменять не.будет2 ладно
через ассоциация мы постараться сделать так чтобы вы в свой город например в новосибирск находить филиал этот ассоциация и приходить туда	есть тоже мочь поэтому уже группа шить2 шить2 шить	1ps через содружество 3ps 1ps адрес список 1ps будет раздавать2 все это 3ps адрес свой новосибирск 3ps другой город будет приходить2
а если я не прийти домой папа и мама обязательно сообщать в милиция	если я не принести дом семья и мама плюс милиция плюс	1ps домой не будет родители должен полицейский милиция предупредить
лето сам себя нужно купаться	лето сам себя покупать лето сам себя покупать	indx лето обязательный купаться
когда наступать ночь они отдыхать	где наступать ночь ония отдыхать ночь обнимать ночь обни	когда ночь начало отдых
это я очень нужно потому что я получать различный информация о музей город благодаря этот организация	indx уже сильно изучать различный информация о музей город благодаря indx 1ps 	1ps indx быть включать это нужда indx различный pl получать информация все получать вечный у 3ps содружество перечислять2 получать2 indx быть музей работать2 включать indx город страна indx 1ps вечный
мать девочка сильно выпивать после развод с отец и оля всегда сторониться ребята чувствовать себя обделять	родитель чувствовать себя с отец и олень	мама poss 3ps девочка проходить расстаться папа сильный алкоголь и <dact> 3ps всегда2 <nums> лишний2
вода холодный или ты притворяться	ты притворяться вода холодный или ты притворяться или ты притворяться или ты	вода холодный или 2ps притворяться
благодаря вот этот механизм ускоряться снижение вес	благодаря вот этот механизм ускоряться снижение весной ускоряться	благодарение это indx собирать indx успех вес худеть
дочка сидеть зажиматься в угол	дочка сидеть зажиматься в угол уголок сидеть зажиматься в	дочь сидеть угол прятать
но иногда смотреть на человек и думать что у он жировой запас даже слишком много и пора останавливаться	результат indx смотреть на человек испытывать что усердный плюс плюс	видеть человек 3ps <dact> жировые.запасы куда хватит конец
мы с она знакомый	мы сказать знакомый	1ps pl вместе знакомый
я приходить в тот школа в который среди слышать ребенок быть код приходить туда смотреть помогать	я призывать ребенок indx плюс дисциплина где приходить вчера 1ps 	кто indx дети слышащий кода включать 1ps помогать 3ps 1ps приходить 3ps проводить indx приходить смотреть indx
обнимать и до следующий встреча	обнимать и до годовать нормально главный и до годовать : 3ps	обнимать все до следующий встреча пока
подключаться быть вы ждать	есть плюс плюс жать плюс 2 жать вы ждать вы ждать вы	ждать2 poss 2ps 2ps подключаться 1ps
вы быть получать различный поручение	вы жевать различный поручение	желание пример поручать различный
я быть учитывать возможность ваш город	я учить возможность ваш город	1ps обучать2 потом потому.что город poss 2ps
также вы мочь находить я в соцсеть ВК фейсбук и написать я задавать вопрос я отвечать	также мочь называть вопрос я вчера 1ps : 3ps : 3ps 	кто узнать2 мочь 2ps 1ps соцсеть ответ в-к фейсбук написать вопрос 1ps отвечать
следующий вога клуб глухой	последовательно вога клуб глухой	следующий2 <dact> клуб глухой
я сам глухой общаться на жестовый язык мой родитель а также бабушка и дедушка тоже глухой и мы нормально общаться на жестовый язык	я сам2 нормально общий язык мочь нормально главный язык мочь	1ps сам2 глухой poss 1ps говорить на жестовом языке poss 1ps родиетли глухой бабушка дедушка глухой 3ps pl говорить на жестовом языке нормально
если бы я не пойти работать переводчик я бы выбирать направление сурдопедагог и обучать бы ребенок с нарушение слух	если если я не покидать путь нормальное слух если	если 1ps поступать работать2 переводчик 1ps выбирать другой специальность направление <dact> преподавание обучать2 дети2 нарушение2 слух
да	да	д-а
укус лори мочь вызывать анафилактический шок и даже смерть говорить что лори подражать змей ядовитый	лафер indx вызывать анафилактика плюс гаристань лаже	это 3ps кусать мочь 1ps <dact> 1ps смерть мочь2 это осторожно <dact> 3ps копировать змея похоже
о нет ты не мочь поехать на королевский бал в такой вид	ты не мочь поэтому уже о нет общий шаг в такой видеть	нельзя уезжать королевский праздник бал такой 2ps
мы видеть что человек стоять взгляд испуганный	мы видеть что человек стоять взгляд испугенныйный взгляд испугенныйный	1ps 1ps видеть человек стоять глаза какой clf clf.глаза clf.расшириться напуганный indx кашлять2 останавливаться
ехать нужно быть далеко но луиза не мочь пропустить такой событие	есть тоже мочь не мочь мочь мочь мочь мочь мочь мо	поехать далеко н-о пропускать3 не мочь
семья это труд друг о друг забота	родитель это труд родной о друг о странать труд о друг о	семья это труд делать друг.друга забота
например на помещение	пример на помещение шить шить шить шить шить шить шить	пример комната комната
на седьмой место муравьед	седьмой мест муравьедёмный адрес муравьедьедробье	следующий3 <dact>
он вчера не купить мясо	indx не купить мясо	о-н 3ps вчера мясо покупать не был
он быть страшно но он стараться не показывать это	indx старать не мочь это нормально	о-н был страх н-о стараться н-е показывать
жир сжигаться быстро и превращаться в энергия	жир сжигать быстро и превращать плавание и превращать плавание	<dact> огонь быстрый изменение энергия
и как раз когда мы общаться в фейсбука там быть человек по имя аркадий белозовский	где мы общать человек по имя аркадий аркадий родной дом семь	<dact> <dact> связь когда фейсбук indx был беседовать indx имя <dact> <dact>
по-прежнему пусто	по-прежнему пусто-прежнему пусто-прежнему пусто-прежнему	пустой то.же.самое
у я быть принтер	я быть принтер	1ps принтер2 иметь
а также углеводный пища потому что повышаться сахар и инсулин в кровь	потому что потому что потому что потому что потому что потому что по	плюс <dact> еда indx тоже почему сахар2 выше <dact> кровь тоже выше
для то чтобы вы быть заразный у вы не должно быть антитело	indx для нормально главный удостоверный удостоверный удостоверный удостоверный	если 1ps заразный 1ps необходимость внутри защита не иметь
мой жена тоже учиться в ЛВЦ она знать	сын знать вчера 1ps : 3ps indx знать	poss 1ps жена лвц учить2 знать пример
в это институт учиться глухой и я там быть	есть институт учиться глубоко мир indx испытывать глубоко мир indx и	институт глухой толпа есть indx это 1ps был indx
код из разный страна сразу узнавать друг друг радоваться начинать взаимодействовать друг с другой	разный страна узнавать родной страна с родной страна с изучать родной страна с	глаз знать poss 1ps 1ps пример 1ps италия2 русский пусть <dact> 3ps одинаковый 3ps нейтр.имп радость clf clf.взаимодействовать общаться
следующий этап начинать копить на случай если оставаться без работа увольняться тогда что делать а резерв всегда быть	если если случай если оставить2 случай если оставить2	потом следующий все4 потом начинать копить вдруг 1ps не.работать уволиться что pl делать оставить есть
поэтому хром уменьшать тяга к сладкий	поэтому уже группа уменьшать тяга к сладкий	<dact> уменьшать2 3ps тянуть 1ps сладкий
хорошо	нормально нормально нормально нормально нормально нормально нормально нормально нормально	хорошо
абсорбция другой соединение хром незначительный и составлять мало	результатированный вентиляция нечестный ископлять слабый соединение слабый	<dact> соединение успех мало меньше <nums> процент
за вертолет платить кто будет	кто платить кто плюс вертолет платить кто плюс вертолет плат	вертолет деньги кто будет
почему	поэтому почему поэтому почему поэтому почему поэтому почему поэтому по	почему
у мой брат быть чистый носок	сын читать чистый носок	poss 1ps брат чистота носки иметь
изменяться мир ваш семья друг и коллега весь изменяться	приятель изменяться мир и коллега вчера изменяться мир и коллег	ваш семья мир изменить друг pl вместе работать все изменить будет
это агенство вообще мочь выделять переводчик на любой мероприятие вы же знать что вы по закон положенный переводчик поэтому не надо стесняться он просить	результат indx не мочь переводчик или мочь2 все общий переводчик или мочь	это indx это выделить перевод indx любой деятельность что соревнование indx подать.заявление и обратиться 2ps перевод пожалуйста обслуживать все терпеть должен закон indx есть все должен обслуживать перевод
получаться я продолжать работать и плюс обучать студент будущий переводчик	студент продолжать нормально плюс обучать плюс обучать плюс обучать плюс	1ps получать2 1ps продолжать работать2 оставаться2 продолжать еще работать2 плюс 1ps учить студент2 будущее переводчик
гордиться	гордиться гордиться	гордый
вдруг ларсить замечать вдалеке свой папа	вчера ларвать замечать вдалеке мой папа	случай <dact> замечать clf clf.вдалеке indx папа видеть
следующий рыба фуга большой круглый рыба с пятно	последовательно рыба фуга большая рыба большая рыбга большая рыбга большая рыб	изменить.направление рыба2 <dact> clf clf.рыба clf.круглая пятно pl clf clf.рыба clf.круглая
говорить голос и жест одновременно	говорить голос и жестовый говорить голос и жестовый говорить голос и	жестовый язык
привет	приветствовать привет	привет
это специальный группа слышать ребенок у который родитель глухой	есть специальная группа слышащий ребенок уходящый родной где есть	это специальность группа дети2 слышащий poss 3ps папа глухой
верно	верно верно верно верно верно верно верно верно верно	правильно
во-первых в состав максимально эффективный комлпекс компонент экстракт гарциния и пиколинат хром	во-первых вставить эффективный комлпекс анализировать спектр комл	первый собирать indx есть тупик полезный общий <dact> и <dact>
она входить вытирать рука о полотенце	носить рука о полотенце	clf clf.человек clf.идет потирать.руки
вдруг он услышать в лес возмущать разговор зверь медведь заяц белок птица	результат indx слышащий родной услышащий родной услышащий род	слышать indx лес что разговаривать2 <dact> что indx был разговаривать2 медведь возмущаться заяц <dact> птица множество смешанный
молчать	молчать молчать молчать	молчать
что за надоедливый крыса что ты нужно	что за новоедливый крыша необходимость крыша что за новоедливый кры	случай крыса2 вредный что желание
например масло коллаген и то что иметь глубокий увлажнение чтобы ухаживать за волос	масло коллаген испытывать глубокий увлажнение что иметь	пример масло ухаживать глубоко масло <dact> заботиться что был
я белый мишка с северный полюс	я белый мишка с северный полюсный полюсный полюсный ми	1ps белый медведь жизнь северный.полюс
приходить посмотреть дом рядом с лес там жить мальчик который играть в лес	приходящая житель жить дом семья жить дом семья жить дом семь	приходить2 смотреть2 рядом дом indx мальчик жизнь территория близко <dact> indx indx мальчик был indx дерево pl игра
нужно поставлять ряд задача написать устав	есть необходимость дисциплина написать устав	нужно поставить pl список задание pl <dact> список список <dact> закон
чужой	чешская сосед править чужий	чужой
у я в голова не укладываться вообще вот такой вот случай быть	я вчера случайывать нормально уже случай indx случай indx случай	1ps 1ps тупик ап попадать случай был
сделать маленький десятисекундный репортаж и показывать	маленький репортаж и показывать маленький репортаж и показывать	видео2 маленький4 <nums> секунда отправлять 3ps новости показывать
запираться	запирать запирать	выключить
скоро вс починять	скоро вс началять скоро вс начало	скоро чинить готовый будет
следующий лебедь очень красивый птица который жить пара и с который у мы связанный много представление о любовь	результат indx пчела так оставить пара испытывать пара испытывать пара	следующий3 <dact> clf clf.птица clf.машет clf.крыльями clf clf.длинная clf.шея красивый clf clf.два clf.лебедя clf.склонили clf.друг clf.к clf.другу clf.головы всегда2 clf clf.два clf.лебедя clf.склонили clf.друг clf.к clf.другу clf.головы милый видеть всегда2 внутри любовь2 clf clf.два clf.лебедя clf.склонили clf.друг clf.к clf.другу clf.головы clf clf.птица clf.машет clf.крыльями
и я весь время поглядывать на ефросинья петровна	я весь время похудывать на ефрасинья петроинья по	1ps всегда2 видеть взглянуть бабушка 3ps делать что
я показывать презентация	я показывать презентация	1ps показывать мультимедийная.презентация indx
привет я звать елфимов светлана вот мо жестовый имя	привет я звать Елфимов слабый родной ураганов родной ураган	аплодисменты 1ps имя <dact> <dact> poss 1ps жестовое.имя sn
сейчас жестовый язык популярный в мир слышать	сейчас жестовый язык распространный в мир слышащий родной улица 1ps 	сейчас жест известный indx мир говорить
соглашаться	соглашаться соглашаться	согласие
в Instagram быть группа мама в дело	Instagram быть группа мама вчера вчера группа вчера группа вчера	в instagram 1ps есть группа мама дело indx
даже к подросток нужный другой подход	подросток необходимость больший подход на сам2 развивать конец indx подход indx даже	даже подросток переезд средний2 другой работа будет
например я работать в технологический музей видео гид и у они там очень хороший финансовый положение	есть шить2 шить2 шить2 шить2 шить2 шить2	пример 1ps делать технология музей и indx поручать видео <dact> indx финансирование2 лучше
перечить она не сметь	есть не сметь нормально	перечить
следующий жестовый пение театр глухой история или рассказ на РЖЯ	чешская глубоко русский глубоко мирная пение театр глубоко мирная п	следующий2 жест пение театр глухой poss 3ps история жест рассказ <dact>
ребенок не осведомлять об это почему	ребенок не осведомлять об это поведение поэтому поэтому поэтому поэтому по	3ps pl не знать почему
оказываться очень важный знать что у он быть друг	сильно важный знать что уто есть родной дом семья сильно важный	оказываться очень важный если знать у 3ps есть друг
что нужно делать	что необходимость образование делать что необходимость образование делать что необходимость образование делать что	что делать нужно
привет	приветствовать привет	привет
или написать свой мнение	есть мой мнение написать мой мнение	или poss 2ps pl мнение написать
это подходить то кто хотеть но не мочь копить	кто подходить то кто мочь копченный ночь копченный ночь копченный	есть кто желание н-о не.получаться копить подходящий объяснять
смерть дорогой цена за красный роза восклицать соловей	попугай восклицать соловей цена	смерть дорогой clf clf.вносить clf.деньги обмен2 красный цветок отвечать птица
отражение роза в серебряный зеркало отражение роза в недвижный вода вот каков быть роза расцветать на верхний побег куст	что роза вчера роза вчера роза вчера роза вчера роза	типа река отражение цветок нежный сиять так2 нежный светлый был цветок расти кусты clf clf.цветок clf.распукается clf.медленно
вопрос как вы относиться к инклюзивный образование когда глухой и слышать учиться вместе	результат indx группа относиться к инклюзия где глубоко мирный образование	вопрос инклюзия образование2 говорить глухой вместе poss 2ps относиться как
и самый сложный это сам человек	самый родной у самый родной indx самый сложный это самый родной	сам2 сложный это человек pl сам2 сложный
старый солдат идти в отпуск	старый солдат делать в отпуск	старый солдат идти отпуск
следующий зима	последовательно зима последовательно зима	следущий весна
нормально весь	нормально весь нормально весь нормально весь нормально весь нормально в	нормально
восхищаться	восхищать восхищать	восхищаться
у слышать билет стоты дорогой	у слышать билет стоты дороги	у слышащий стоимость деньги больше
и что же теперь делать раз нет	indx так делать раз нет нормально	отсутствие pl что делать
ах какой счастие восклицать он	ах так оставить носкилицать русский ах	счастье какой счастье кричать
