Russian	Predicted	Truth
а когда дед мороз вернуться домой маленький дед мороз приходить к главный и сказать а я то вон в лес тоже подарок раздавать	когда2 дед.мороз приходить домой маленький clf clf.перемест	indx дед.мороз clf clf.группа clf.переместить домой clf clf.группа clf.переместить дед.мороз маленький встретить приходить обращение главный 1ps был лес подарок clf clf.перечислять
а мачеха лишать я весь радость	а мама второй все радость давать 1ps ноль	мама второй 3ps все радость давать 1ps ноль
зачем я хотеть изменять свой привычка тратить и начинать копить	зачем желание изменение привычка тратить все4 желание именение	зачем желание изменение все4 привычка тратить все4 желание именение привычка свой изменение тратить и копить думать
оказываться впервые это появляться в америка	америка есть 3ps первый прогресс	америка есть poss 3ps 3ps рассказ 1ps интересный америка первый прогресс
я вчера не стирать белье	1ps вчера стирать	1ps вчера стирать <dact> не был
она один за другой скидывать с себя туфля и прямо в один чулок подходить к дверь и у я от радость заколотиться сердце	девочка 3ps скидывать 1ps одежда3 прямо clf clf.человек clf 	обувь2 убирать чулок бродить дверь 1ps думать радость 3ps скоро открывать.дверь сейчас скоро радость сердцебиение
тогда как	<dact> дальше <dact>	<dact> дальше <dact>
заиграть первый луч солнце а друг уже у река	заиграть первый луч солнце друг уже рядом река	утро солнце друг уже рядом река
я весь устраивать я быть интересно учиться и скоро я уже сам начало выполнять даже сложный заказ	все 1ps pl все 1ps учить2 1ps все4 1ps уже clf clf.больш	1ps спокойный2 1ps был интересный учиться и время clf clf.время clf.идет 1ps уже сам2 получать даже сложный 3ps заказывать 1ps
мы отдыхать	мы отдых	мы отдых
нигде	где	<dact>
почему	почему	почему
он уметь кататься на лыжа	о-н знать кататься	3ps знать лыжи
я не понимать то ли она плакать то ли смеяться	1ps не понимать н-о школа плакать есть похоже смеяться	1ps видеть не понимать 3ps плакать или смеяться
в общий немного эмоционально получаться	результат эмоция давать	результат эмоция давать
сегодня мы разбирать ещ один опасный ситуация связанный с дыхание	сегодня объяснять ещё <nums> опасность связать дышать	сегодня объяснять ещё <nums> опасность связать дышать
ты я не только разозлить но еще и расстраивать	2ps еще не только разозлить новый и расстраивать	2ps н-е только2 злость 1ps и плюс 1ps депрессия
хорошо радоваться тогда и дочь быстро поправляться	хорошо радоваться тоже дочь быстрый поправляться	пусть радоваться влиять 3ps дочь быстро здоровый будет
например в россия быть свой традиция	пример россия есть свой традиция	группа пример россия есть свой традиция
мочь быть и я вы помогать	мочь быть говорить 1ps помощь	мочь быть говорить 1ps помощь
сейчас мочь даже слышно в микрофон	мочь быть немного слышать микрофон	мочь быть немного слышать микрофон
кролик увидеть в цветок фея	кролик видеть цветок фея	кролик что цветок и <dact>
он долго плыть и замечать вдали берег	долго clf clf.плыть clf.на clf.бочка замечать виде	долго clf clf.плыть clf.на clf.бочка замечать видеть indx clf clf.берег
жаль что я туда вс равно не попадать	жалость 1ps тоже indx попадать невозможный	жалость 1ps тоже indx попадать невозможный
не весь похоже понимать как это делать для себя а не для другой	все не понимать как это делать	себе делать похоже все не понимать как 1ps для 3ps делать
он отравляться	3ps отравиться	яд
много гриб собирать мальчик в лесной часто	много гриб собирать2 лес	много гриб собирать2 лес
без видео плохо но ладно я вы рассказывать сам история про англия	видео2 плохой 1ps 2ps рассказывать 2ps англия <dact>	видео2 indx плохой 1ps 2ps 1ps рассказывать 2ps англия indx <dact>
он замечательно п к печение любой форма например в вид зв здочка лочек	3ps идеальный печь печенье вкус любой это уметь форма звезда ель раз	это 3ps идеальный печь печенье <dact> вкус любой это 3ps уметь форма звезда ель разный pl
это глагол прилагательное	<dact> <dact>	<dact> <dact>
к себя он приглашать я бояться но однажды он напрашиваться ко я на чай и увидеть мой условие жизнь предлагать пожениться и переезжать к он	1ps себя дом приглашать 1ps бояться н-о вдруг о-	1ps себя дом страшный 1ps приглашать 3ps н-о вдруг о-н 3ps обратиться 1ps imp чай пить о-н 3ps видеть 1ps poss 1ps условие2 все жизнь видеть imp жениться и переезд к 3ps
и вы обязательно нужно давать ответ рассказывать	и 2ps обязанность ответpl 2ps будет	2ps pl обязательно нужда ответ pl рассказ pl ответ pl
когда мы отжимать волос вода на они оставаться	н-о мы жать вода clf clf.вода clf.на clf 	н-о 1ps жать вода clf clf.вода clf.на clf.волосах что необходимость вода оставаться indx есть
хотеть продолжать тема созависимость пренебрежение себя	продолжать тема2 созависимость пребрежение	привет
пищевой волокно связывать большой количество вода в кишечник превращать е в гель который затрудянуть усвоение углевод что сказываться на снижение уровень колебание сахар в кровь	волокна это большой общий собирать вода кишечник изменять еда	еда волокна успех связь3 только2 больше жидкий вода кишечник успех изменять <dact> и успех <dact> indx конец и успех 3ps давать 1ps уменьшать2 уровень колебание кровь
в строчка выбирать вариант или	строчка <nums> ответ	строчка связать <nums> 2ps выбрать <nums> ответ
когда появляться проблема нужно быстро придумывать как они решать	проблема2 быстрый думать решать	проблема2 появляться быстро решать что придумывать быстро решать
потом я становиться искать какой-нибудь конкурс и наш л один который проводить среди слышать проводиться он два или три день в общий сложность	потом искать соревнование все включено это все включено говорить соревнование	1ps искать соревнование indx говорить соревнование 1ps все включено это все включено говорить соревнование <nums> день <nums> день <nums> факт2 indx дактилировать
у я быть я крутой у я быть связь	1ps круто 1ps есть связь2 есть	1ps мочь круто 1ps связь2 есть
я тоже хотеть ходить на бал	1ps тоже желание приходить2 бал	1ps тоже желание посещать pl clf clf.пышная clf.юбка танцевать <dact>
мы знать это животное по мультфильм оно выглядеть так мило что мы и не думать о то что оно опасный а оно опасный	знать это животное2 мультфильм2 интересный н-о 3ps опасный	знать вы животное2 мультфильм2 интересный clf clf.милая clf.пушистая clf.мордочка милый 3ps думать неопасный н-о 3ps опасный есть
наш организация существовать с го год	poss 1ps организация существовать <nums> год	это poss 1ps pl организация существовать уже <nums> год
видеть по-разному	видеть разный	видеть разный
второй шаг	второй шаг	второй шаг <dact>
что вообще мочь сделать мы счастливый легко и быстро	что вообще что мочь мы делать мы делать счастье очень легко2 быстро	как вообще что влиять на 1ps мочь мы делать счастье очень легко2 быстро2
подруга рассказывать о свой проблема я тоже поделиться свой	подруга рассказывать 2ps собственность проблема2 3ps рассказывать 1ps собственность проблема2 3ps рассказ	друг 3ps рассказывать 1ps собственность проблема2 3ps рассказывать 1ps 1ps тоже 1ps рассказывать 3ps делить
хорошо	хорошо	хорошо
немного зима посмотреть и лето быть	немного зима смотреть лето был	немного зима смотреть2 лето есть
хитрый	хитрый	хитрый
номер три это животное который называться древолаз	еще <nums> животное <nums> точка2 <nums> точка2 2 <dact>	еще есть животное2 назвать <dact>
а человек видеть мир по-разному	а человекpl видеть различный	а человек pl видеть различный
в год в павловск построить ленинградский восстановительный центр	<nums> год павловск <nums> стройка ленинград восстанавливать центр	смотреть <nums> год <nums> год павловск <dact> indx стройка clf ленинград восстанавливать центр
мой бабушка не любить гулять ночь	poss бабушка не.любить гулять ночь	poss 1ps бабушка2 не.любить гулять ночь
нет так нет ну и ладно	нет2 так нет2 н-у ладно	нет2 так нет2 н-у
такой человек называть элита	такой человекpl назвать <dact>	новый все человек pl назвать <dact>
сейчас я видеть весь больше и больше небольшой команда который пытаться что-то делать как-то развиваться	сейчас все4 больше маленький3 команда и-п сам2 достигать так	сейчас всё 1ps видеть больше маленький3 команда и-п сам2 достигать так развивать
ребенок весь понимать	все понимать2.наизусть	все дети понимать2.наизусть
няня весь собирать и выбрасывать а мальчик давать новый белый с блестящий мех	няня все собирать2 новый выбрасывать новый мальчик давать новый	няня2 ладно собирать2 выбросить2 мальчик давать новый белый мех блестящий
для кто-то нужно утяжеление для кто-то чтобы быть разглаживание	кто тяжелый clf clf.волосы clf.тяжелые clf clf 	<dact> кто тяжелый clf clf.волосы clf.тяжелые <dact> кто clf clf.волосы clf.гладкие clf clf.волосы clf.лежат clf clf.волосы что был
начальник говорить мы же готовый он взять у мы быть такой рабочий место но по факт человек с инвалидность никогда не пойд т на это место	начальник говорить мы готовый принять такой место н-о п-о	начальник говорить мы готовый принять такой место у 1ps есть приглашать но п-о факт2 никогда это место инвалид вступить.не
ты должный позвонить мама а то она будет беспокоиться	2ps должен мама звонить.по.телефону 3ps волнение будет	2ps должен мама 1ps звонить.по.телефону 3ps 3ps волнение будет
я сидеть в свой комната учиться не пойти но жить на что-то надо быть	комната учиться нет нужно деньги жизнь	всегда2 сидеть комната учиться нет нужно деньги жизнь
я обращаться и в другой место например в вога и там я тоже оформлять письмо поддержка такой образ уже они у я быть несколько	1ps обращаться 1ps другой место пример 1ps <dact> indx тоже оформлять письмо поддерж	другой pl посещаемость надеяться indx и 1ps тоже <dact> 1ps обращаться <dact> тоже indx 3ps поддерживать 1ps печать 1ps повезло clf clf.складывать clf.письма clf.вместе уже
я не нравиться яркий одежда	яркий одежда2 1ps не нравиться	1ps яркий светлый одежда2 не нравиться
глупый	глупый	дурак
сейчас для наш человек это возможность действительно заниматься любимый дело	сейчас и 1ps человек это возможность действительно делать	сейчас мы человек pl это возможность действительно работа любить работа
если педагог видеть что он разговаривать хорошо и весь понимать то он без проблема идти в отделение и учиться год	если смотреть человек хорошо разговаривать2 хорошо понимать все <nums> год <nums>	если смотреть ребенок разговаривать2 хорошо понимать все <nums> подразделение год <nums> учить2 не
потом домой приходить и мама просить еще урок проводить	потом домой приходить и мама просить еще урок проводить	домой мама еще считать3 уроки
например двое мой ребенок говорить на жестовый язык	дополнение пример poss 1ps дети говорить на жестовом языке	дополнение пример poss 1ps дети <nums> глухой не говорить на жестовом языке
почему у мы в россия это не популярный	почему у 1ps россия популярный нет2 почему	1ps россия популярный нет2 почему
журналист просто бер т этот новость и публиковать на сайт с красивый картинка	2ps взять публиковать картина	1ps взять публиковать 1ps отправлять 3ps <dact> красивый картина
я жить в краснодарский край	1ps жить место краснодар территория	1ps жить кавказ место краснодар территория
нужно изучать основа чтобы иметь общий пердставление о они чтобы экскурсовод мочь об этоя рассказывать	основной2 нужда изучать что общий есть общий пердставление бумага	основной2 нужда изучать что общий получать воображение 3ps pl рассказ indx будет экскурсия человек экскурсия человек
я вы совсем не знать но я кажется готовый смотреть в ваш глаз вечность	дорогой девочка знакомый не 1ps не знать н-о 1ps казаться 1ps	дорогой девочка знакомый не 1ps 2ps совсем не знать н-о 1ps казаться 1ps poss 2ps глаз pl готовый зрительный.контакт вечность
а этот мужчина быть сантехник который чинить прорыв канализация и который обливать дерьмо тома давать он халат муж и разрешать подождать пока он привозить чистый вещь	а мужчина2 это мужчина2 сантехник сантехник clf.из clf 	а мужчина2 это кто сантехник <dact> сантехник 1ps исправлять 3ps туалет канализация clf clf.облило clf.из clf.канализации грязь туалет <dact> для халат муж и зафиксировать пока приносить чистый poss 3ps одежда3
скоро быть праздник	скоро будет праздник	скоро будет праздник
пока спасатель ехать мальчик сидеть рядом и следить	пока спасать clf clf.человек clf.идти clf.на clf	пока спасать clf clf.человек clf.прийти 3ps мальчик рядом следить н-о жалость
весь целый весь пока	все пока	воздушный.поцелуй аплодисменты
усердный	усердно.трудиться	усердно.трудиться
открываться дверь	дверь открытый	открывать.дверь
он мочь бить себя по грудь или по стол пытаться показывать что он плохо и нужный помощь	бить себя clf.человек clf.хлопать clf.по clf	получаться 3ps clf clf.хлопать clf.по clf.грудь clf clf.хлопать clf.по clf.стол тоже показывать все 3ps помогать 1ps тоже плохой
представлять что инициативный группа хотеть разрабатывать проект который помогать избавляться от этот проблема и не давать она развиваться	представлять группа гап делать проект это проблема2 убирать живот развитие нет	ладно группа гап делать indx проект проблема2 убирать живот развитие нет проблема убирать
жертва это когда вс что ты делать ты делать в ущерб себя	жертва это когда2 2ps делать 2ps делать отдавать.себя думать	<dact> называть <dact> что делать 1ps делать отдавать.себя себе думать нет
медвежонок плыть на льдина	медведь плыть clf clf.толстый clf.предмет clf	медведь маленький3 clf clf.круглый clf.предмет clf.плыть clf clf.толстый clf.лед <dact> clf clf.запрыгнуть clf clf.на clf.четырех clf.лапах плыть
я этот никто не учить	1ps никто учить не	1ps научить 1ps никто
например дма она заставлять она делать самый тяжелый работая	пример дом самый сложный тяжелый труд	например дом самый сложный тяжелый труд clf clf.сесть clf.на clf.шею
на улица быть тепло и мальчик хотеть пойти гулять однако начинаться дождь	улица есть мальчик и пойти4 гулять желание дождь бытьpl	indx смотреть улица теплота мальчик желание выходить гулять начать дождь
смотреть на вы	смотреть 2ps	смотреть 2ps
что там	что indx	что indx
он облизываться	вкус облизывать	вкус облизывать
идентичность я глухой и ты глухой	одинаковый 2ps глухой 1ps одинаковый 2ps одинаковый 2ps глухой кровь	следующий2 яг 1ps одинаковый 2ps 1ps глухой кровь2 2ps глухой 1ps одинаковый 2ps
если весь быть копить не нужно откладывать на всякий случай	копить только все4 будет копить не.нужно все есть запас вклад	копить 1ps копить не.нужно все есть это запас вклад
сура в адаптис плохой перевод в субтитр такой замечание	<dact> <dact> плохой субтитры перевод плохой замечание2	<dact> <dact> плохой субтитры перевод плохой замечание2
у я нет сила	1ps сила дефицит	1ps сила дефицит
этот верхний пункт сокращать но затратный ресурс быть всегда	это clf clf.деньги clf.уменьшаться н-о расходы все	это clf clf.деньги clf.уменьшаться <nums> расходы <dact> всегда постоянный тратить pl
здесь жить дружно поколение старший бабушка и дедушка средний мама и папа и младший ребенок катя и антон	indx дружба жить вместе <nums> поколение старший бабушка2 дедушка второй	indx дружба жить вместе <nums> поколение старший бабушка2 дедушка второй мама папа третий младший дети <dact> <dact>
я должный завершать еще пара важный дело пока	должен быть завершать еще <nums> дело обязательный пока с утра до вечера	1ps должен конец <nums> важный дело пока
понятно	понятый	понятый
сегодня мы продолжать разбирать программа slim	сегодня2 продолжать <nums> д <dact>	сегодня2 продолжать <nums> исследовать <nums> д <dact>
но сначала давать разбираться как усваиваться пища	н-о первый давать <dact> это <dact> воспринимать	н-о исследовать <dact> 1ps еда воспринимать <dact>
рассказывать еще	рассказывать еще	жестовый язык кто еще был рассказывать
терять	потерять2	потерять2
он приносить одеяло из дом и накрывать собака обращаться к взрослый за помощь	одеяло дом clf clf.взять clf.принести одеяло clf.	одеяло дом clf clf.взять clf.принести одеяло обращаться взрослый помогать 3ps 3ps
даже мэр город приезжать чтобы успокаивать мальчик	даже мэр город приходитьpl 3ps успокаивать 3ps 3ps pl	и даже <dact> город поехать гость 3ps 3ps успокоить 3ps 3ps pl
например компьютер ноутбук проектор стул стол и всякий вещь	пример компьютер компьютер стул стул всякий	пример компьютер ноутбук проектор мелочь стул pl стол был
здравствовать	здравствуйте	здравствуйте
сейчас я объяснять как и что	1ps сегодня2 1ps рассказывать 2ps что <dact> это	1ps сегодня2 1ps рассказывать 2ps что <dact> это
она просыпаться и она быть очень тесно	просыпаться тесный был тесный	проснуться и тесный был нормальный тесный
идти дождь и мы решать оставаться дом и посмотреть фильм	дождь и решать оставаться дом смотреть	дождь 1ps думать решать оставаться дом и смотреть2 фильм2
весь что она удаваться находить это работа дворник в соседний двор но больший она и не нужно быть главное что хватать платить за квартира а на ехать она надо быть совсем немного потому что она почти ничто не есть и похудеть до неузнаваемость	все все куда находить это работа дворник сосед indx территория н-о	и все что мочь2 успех только2 работать дворник сосед indx территория н-о дворник достаточно квартира платить есть деньги еда должен нет много <dact> чуть-чуть еда нет ничего2 худеть видеть лицо узнать нет
кто она резать	кто резать	3ps кто 3ps разрезать 1ps
что вообще представлять себя этот организация и зачем она нужный	организация почему	это организация здесь для что
видимо становиться больше сажать культура и из-за большой количество урожай он становиться собираться поздно	большеpl больше расти <dact> урожай собирать2 выше.крыши уже	больше clf clf.сажать clf.в clf.землю урожай собирать2 выше начинать позже собирать2
в это место очень много турист благодаря то что здесь много исторический здание	indx толпа турист поэтому indx много история множественный	это место много 3ps приезжать путешествие <dact> почему это место2 много исторический clf музей разный
семья это много домашний работа	семья это много домашний работа	семья это много дом работать
но я никогда не встречать	н-о 1ps встречаться никогда	1ps встречаться никогда
потому что нет общение нет любовь и понимание и он быть просто как собачка это очень страшно а у тот трое быть семья любовь общение и вот это реально до мурашки	общение ноль2 любовь ноль2 игнорировать2 ноль2	общение ноль2 любовь ноль2 обнимать ноль2 игнорировать2 одинаковый собака2 clf clf.собака clf.прислушивается папа иса indx боль 3ps pl общение это 3ps pl 3ps pl спасибо общение делить думать сохранение понимать спасибо папа папа 3ps clf clf.мурашки clf.по clf.коже
в ноябрь будет год как я официально работать переводчик	ноябрь официальный 1ps работать2 переводчик уже <nums> год	ноябрь официальный 1ps работать2 переводчик уже <nums> год
я ждать твой звонок но ты я не позвонить	1ps ждать2 poss 2ps звонить.по.телефону 1ps 2ps звонить.	1ps ждать2 когда2 3ps звонить.по.телефону 1ps 2ps тоже 3ps звонить.по.телефону 1ps нет2
рядом с печень желчный пузырь который удерживать желчь до необходимый момент	печень рядом <dact> clf clf.желчный clf.пузырь clf	печень рядом <dact> <dact> clf clf.желчный clf.пузырь indx <dact> действие оставить нужно clf clf.желчь clf.убрать
лев лишь рассмеяться	смеяться смеяться смеяться смеяться смеяться смеяться смеяться смеяться смеяться сме	смеяться3 лев смеяться смеяться3
интересно	интересный	интересный
я быстро получать обещать жилье но это быть маленький комнатка в коммуналка где сосед ввергать в шок при первый же встреча	1ps быстрый получать дом это был маленький3 комната соседpl все су	1ps быстрый получать дом это был маленький3 комната сосед pl квартира сосед pl все сумасшедший3 1ps взглянуть
осаня начинаться в конец октябрь в ноябрь или декабрь	всегда осень2 начинать октябрь последний3 ноябрь декабрь	всегда осень2 начинать октябрь последний3 ноябрь декабрь всегда изменить.направление
интересно так	clf clf.интересно clf.что	интересный так
второй вариант частично да частично нет	второй половина да половина <dact> слабый	второй половина да половина <dact> слабый
ничто из еда нет	еда ничего3	еда indx pl ноль
я любить голубой цвет а мой сестра ненавидеть он	1ps любить голубой цвет голубой poss 1ps сестра ненавидеть2	poss 1ps любить голубой цвет голубой poss 1ps сестра ненавидеть2
переводчик слушать речь и переводить на жестовый язык	переводчик слушать речь2 рассказывать.на.ржя рассказывать переводить	переводчик слушать 3ps речь 1ps 2ps 1ps рассказывать.на.ржя рассказывать переводить рассказывать переводить
если бы у мы в школа россия знать что глухой ребенок из семья глухой свободно говорить на жестовый язык и он учить бы переход с жестовый язык на русский то в школа бы привыкать обучать на жестовый и у ребенок быть бы грамотный русский язык	если б-ы у 1ps россия россия площадь б-ы школа россия	что если б-ы poss 1ps россия площадь б-ы школа вокруг знать ребенок глухой семья глухой говорить на жестовом языке <dact> переезд школа б-ы привычка обучать2 жестовый язык поменять грамотность poss 3ps русский язык
веселый	веселый	веселый
первый вариант принимать такой как быть	первый принимать такой3 как есть	первый принимать такой2 как есть
а если с реб нком в семья общаться при помощь устный речь а жестовый язык считать ненужный это не совсем CODA	а если есть кто семья глухой дети2 родиться слыша	а если есть кто дети2 мама семья глухой ребёнок дети2 родиться слышащий говорить2 жестовый.язык не.нужно говорить2 беседовать poss 1ps кода indx нет indx
этот чувство доброта и любовь появляться в человек сам по себя	этот чувство доброта и любовь появляться человек сам2 себя	чувство добрый любовь появляться человек автоматический согласие
когда я забеременеть то так же работать до последний а потом еще и на дом брать подработка	когда2 1ps беременность 1ps беременность до <nums> работать до <nums> приближаться плюс	когда2 1ps беременность 1ps работать до <dact> приближаться плюс дом получать pl работать
как становиться эмоциональный энергичный воодушевлять свой жизнь	как стоять эмоция энергия воодушевление свой жизнь как	как стоять эмоция энергия воодушевление свой жизнь как
год он лечиться и выздоравливать	учить2 уже выздороветь	год <nums> лечение заболеть здоровый
ты знать кто я	2ps знать кто 1ps	2ps знать кто 1ps
также природа выделять жир роль запасной энергоноситель т е поступать жир пойти на образование энергия но только в случай крайний энергодефицит	успех и плюс природа давать 1ps электричество <dact> <dact> и-з	успех и плюс природа 3ps давать 1ps электричество <dact> <dact> indx 3ps отправлять 1ps н-а основывать электричество только2 если 1ps электричество недоставать
заболевать	заболеть	заболеть
дедушка помогать антон они вместе записывать весь история семья	дедушка помогать 3ps вместе делать вместе история семья	дедушка 1ps помогать 3ps <dact> вместе писать записать все история семья
на это мероприятие приглашаться весь дама и королева который хотеть повеселиться и отдыхать вместе со я принц это королевство сын король и наследник престол	это мероприятие праздник приглашать все девочка кто мечтать желание веселиться	это мероприятие праздник приглашать все девочка кто мечтать желание веселиться отдых 1ps вместе 3ps 1ps принц руководить это территория сын король наследство дать 1ps престол
дотащить он мешок в лес и раздавать подарок весь животное они очень обрадоваться	clf clf.принести лес и подарокpl каждый животное2 подарок	clf clf.принести indx лес и подарок pl каждый животное2 подарок все возбуждение
на концерт	зал	зал
он лежать мертвый в высокий трава и в сердце у он быть острый шип	о-н смерть трава clf clf.в clf.траву серд	о-н смерть трава clf clf.птица clf.упала clf.в clf.траву сердце птица2 indx был острый шип
женщина любить носить шуба они тоже защищать от ветер	женщинаpl носить шуба2 тоже ветер защита	женщина pl любить носить шуба2 тоже включать ветер защита
снег растаивать потому что выглядывать солнце	снег таять почему солнце	снег таять почему солнце
этот конкурс следующий конкурс увидеть принимать участие	это соревнование следующий соревнование заметить3 это 2ps видеть участие	indx соревнование следующий соревнование заметить3 это 2ps стараться принимать участие
если вы решать участвовать в конкурс быть бы хорошо если бы у вы уже быть готовый проект потому что так легко будет о н м рассказывать доказывать он нужность	если мочь был 2ps pl уже clf clf.уровень clf.в	что любой соревнование принимающий участие желание б-ы проект все готовый легкий принимающий участие проект есть легкий принимающий участие 1ps рассказывать 2ps доказывать легкий
этот организация только для слышать ребенок CODA	это организация только2 дети2 слышащий кода	indx это организация только <dact> дети2 слышащий кода
но помнить что масло бывать опасный	н-о помнить что масло бывает это опасный	н-о помнить что если масло бывает это опасный
грубый	грубый	грубый
раз ты просить я подождать	2ps просить 1ps ждать	2ps просить 1ps ждать
наш сми за вс в то число и за размещение публикация хотеть получать деньги	у 1ps pl все желание деньги расходы	у 1ps pl <dact> желание деньги нужда публиковать новости так ведомый деньги
самостоятельно выбирать ответ пожалуйста	сам2 нажать отвечать пожалуйста	сам2 нажать отвечать пожалуйста
благодаря сплоченность весь команда они выигрывать	благодаря команда дружба принимающий участие	спасибо команда дружба 3ps pl найти
и слышать и глухой приходить и организовывать свой группа	слышащий толпа приходитьpl свой группа	приходить pl слышащий толпа группа pl свой группа глухой
опытный	опытный	опытный
вс весь пока	все пока	все пока
ждать ваш звонок	ждать2 poss 2ps pl звонить.по.видеосвязи	ждать2 ваш звонить.по.видеосвязи
крепкий	крепкий	твердый
например здесь в россия мы открывать свой организация код но мы выбирать русскоязычный название слышать ребенок в семья глухой	пример 1ps здесь россия 1ps создавать2 кода и 1ps называть слыш	пример 1ps здесь россия 1ps создавать2 кода а факт2 clf clf.появиться называть <dact> poss 3ps россия 1ps называть слышащий слышать дети2 семья глухой
еще бывать по-другому при полный блокада дыхательный путь ситуация тяжелый человек не мочь говорить кашлять и дышать т е полный тишина	еще быть другой <nums> дышать дышать не мочь	еще по-другому если полный indx останавливаться это тяжелый человек говорить не.мочь.сделать кашлять2 не мочь дышать не мочь 1ps молчать тихий
я быть сильно тосковать когда ты не становиться	1ps сильный скучать сильный скучать без 1ps	отвечать 1ps будет очень сильный скучать без вы
ставить лайк и деваться этот видео если оно ты понравиться	ставить.лайк и деваться это видео если 2ps нравиться	ставить.лайк и делиться это видео если 2ps нравиться
я повезти что проект быть выполнять давно	1ps повезло что проект был выполнять	1ps повезло и проект давно был выполнять
кто не видеть это видео в описание будет ссылка на это он и ссылка на плейлист урок остеопатия там вы находить очень много полезный и интересный	кто видеть не видео2 будет ссылка копировать о писать <dact> мо	кто когда2 видеть не видео2 будет indx копировать копировать о писать <dact> это урок <dact> мочь видеть и мочь успех кто интересный множественный очень полезный
нечего дом сидеть с малыш я сам справляться а ты быть прибегать и кормить он	бесплатный прохлада хватит 1ps сам2 ребенок 1ps сам2 помощь ребенок	бесплатный прохлада хватит 1ps сам2 ребенок 2ps будет приходить и кормить ребенок
специальность быть весь тот же программирование	специальность то.же.самое компьютер	п-о специальность то.же.самое направление компьютер
только сам без мой подсказка	н-о сам2 без poss 1ps подсказывать	н-о сам2 без poss 1ps подсказывать
этот процесс нарастать и человек у который быть килограмм лишний начинать набирать вес ещ быстро словно из воздух	это успех человек это есть множественный лишний вес пример <nums> к-г лишний	успех у 3ps человек это есть лишний вес пример <nums> к-г лишний успех еще больше pl похоже ничего3 похоже больше pl успех
в нет год быть школа грантовый проектирование да	<nums> ш школа г проект дать <nums> да indx	<nums> ш школа г проект п проект да indx
у мой брат нет жена	poss 1ps брат жена нет2	poss 1ps брат жена нет2
начинать учить жестовый язык	начинать учить3 жестовый язык	начать учить3 жестовый язык
и я непонятно почему вдруг опять чихнуть изо весь сила с какой-то даже подвывание чихнуть вот так апчхи уу	1ps новый 1ps зачем не понимать где обмен <dact> <dact>	1ps новый 1ps зачем не понимать 1ps <dact> <dact>
зима здесь очень холодно особенно в январь начало февраль	зима очень заморозить январь февраль срок.между	зима очень заморозить январь февраль срок.между
но получаться так что я глухой я же не смочь быть педагог	успех вот 1ps глухой преподавание не мочь	успех вот 1ps глухой преподавание не.мочь 1ps преподавание
и улучшать углеводный обмен а именно чувствительность рецептор клетка инсулин они снижать аппетит и тяга к сладкий поэтому вечерний капсула рекомендоваться принимать за минута до еда	еще улучшать <dact> обмен еда еще чувствовать ниже е	еще лучше2 <dact> clf clf.организм clf.процесс и чувство <dact> клетка2 <dact> indx ниже еда еще сладкий не.хотеть2 вечер капсула2 советовать з-а <nums> минута до будет еда
мы с вы рано не встречаться	мы.вдвоем раньше встречаться был не был	мы.вдвоем раньше встречаться был не был
так сейчас	сейчас	сейчас
там уже быть показываться другой новость	indx уже будет показывать другой новость	другой новость clf clf.новость clf.подниматься уже
и тогда ваш жизнь обязателньо будет счастливый	и это poss 2ps жизнь обязательный счастье	даже poss 2ps жизнь будет обязательный счастье
я не нравиться этот футболка то быть я не быть она покупать	1ps футболка не нравиться тоже покупать не будет	1ps футболка не нравиться тоже покупать не будет
наказывать	наказание	наказание
следующий одинаковый мировоззрение и восприятие мир	следующий2 мировоззрение восприятие и восприятие	следующий2 мировоззрение восприятие думать мнение pl о мир2 у.всех.одинаково
быть момент когда я нужно быть находить музей и я обращаться к наставник а они находить нужный человек и обменять мы номер	1ps недоставать 1ps искать успех 1ps искать 3ps искать успех и	1ps недоставать 1ps обратиться пожалуйста искать <dact> был 1ps искать нужно это 1ps обратиться пожалуйста <dact> успех 3ps хороший 3ps искать успех и обмен poss 3ps clf clf.сводить clf.людей
а кролик сидеть в мешок переживать вспоминать хороший время как играть с мальчик и общаться с лощадь	а кролик сидеть clf clf.куча clf.куча clf.куча	indx <dact> clf clf.куча кролик переживать помнить был хорошо время мальчик беседовать игра indx лошадь был общаться
какой причина	причина какой	причина какой
привет я звать мир	приветствовать 1ps имя <dact>	приветствовать 1ps имя <dact>
этот механизм будет работать только если мы взять грамм белок грамм жир из жировой запас и грамм глюкоза из гликоген	это indx будет только <nums> грамм <dact> выбирать	успех <dact> <nums> грамм indx <dact> <dact> и-з <dact> выбирать
и чем	и <dact>	<dact>
у я нет никакой одежда	одежда2 1ps нет2	1ps одежда2 нет3 нет2
здесь пособие не выдавать	пособие деньги давать нет2	пособие деньги 1ps помогать 3ps давать 1ps нет2
твердый	твердый	твердый2
мочь быть у вы другой причина я не знать у весь по свой	мочь быть у 2ps pl другой причина 1ps не.знать2 свой	мочь быть у 2ps pl другой причина indx не.знать2 свой pl
тихий	тихий	тихий
нога муж лечить несколько месяц а потом он вернуться домой к нормальный жизнь	нога муж исправлять 3ps месяц проходить а проходить о-н возвращ	indx 1ps исправлять 3ps некоторый месяц а проходить о-н возвращаться домой к обычный жизнь
он постучаться в последний дом и прокричать впускать отдыхать дорожный человек	о-н clf clf.приближаться последний3 дом и прокри	indx последний смотреть стучать2 кричать выпуск дорога2 человек отдых
мы приезжать сюда с цель увидеть храм	мы приезжать зачем что видеть церковь дворец	1ps приезжать зачем что видеть церковь <dact> дворец
если вы сомневаться нужно или не нужно то хорошо добавлять бальзам ничто страшный не будет	если вы сомневаться необходимость не.нужно улучшать добавить можно	если вы сомневаться необходимость не.нужно улучшать <dact> добавлять можно страх не иметь
я можно находить в Instagram во вконтакте	можно находить instagram indx можно вконтакте 1ps	можно находить 1ps instagram indx можно вконтакте 1ps
мокрый	мокрый	мокрый
мы брать разный проект к пример взять один проект и заплатить человек взять второй и третий заплатить тоже	1ps проект пример взять проект 1ps платитьpl 3ps платитьpl 3ps давать 1ps 	проект другой получать pl indx пример indx проект indx зарплата 1ps 3ps человек indx зарплата 1ps 3ps indx зарплата 1ps 3ps
весь что у вы в жизнь происходить будет меняться	все случай что у 2ps pl жизнь происходить будет меняться	все что у 2ps pl случай pl жизнь будет изменить
в год весь немного поутихнуть и решать проводить II съезд глухой	год чуть-чуть успокоить и <nums> год второй форум второй форум	<nums> год чуть-чуть успокоить и <nums> год желание проводить второй форум второй форум желание проводить clf clf.люди clf.собираются clf.в clf.одном clf.месте н-о indx <dact> indx
мой друг захотеть перечитывать сказка владимир григорьевич сутеев	poss друг желание читать дизайн <dact> <dact> <dact> <dact>	poss 1ps друг желание читать дизайн <dact> <dact> <dact>
я должный уметь побеждать в война	1ps обязанность знать победа победа	1ps обязанность качественный стратегия что война победа
там рассматривать мой проект спрашивать чем помогать и помогать я стараться участвовать в любой соревнование в новосибирск и другой город буквально в любой	indx рассматривать проект 1ps обратиться 2ps давать 2ps стараться любой соревнование	clf clf.рассматривать clf.проект что нужно 1ps просить перечислять 1ps давать 2ps стараться любой соревнование что здесь новосибирск традиция город некоторый тоже традиция это indx соревнование успех принимающий участие
если месяц назад то на самоизоляция а если месяц или тогда как	если месяц раньше <nums> месяц т-о самоизоляция если месяц <nums> месяц	<nums> месяц раньше <nums> месяц т-о самоизоляция если месяц <nums> месяц 3 <dact>
когда льдина уже почти растаивать он увидеть в вода деревянный бочка	когда clf clf.льдина таять clf clf.на clf.б	когда быстрый таять clf clf.льдина таять медведь замечать вода indx деревянный бочка clf clf.бочка clf.плывет
например нужно или нет учить характер общение с ребенок	пример характер общаться с ребенок необходимость не.нужно	например характер общаться с ребенок необходимость не.нужно
поэтому должный быть отдельный факультет для тот кто хотеть продолжать качественно учиться с переводчик	поэтому должен быть отдельный <dact> кто желание продолжать качественный clf	поэтому должен быть отдельный <dact> 3ps кто желание продолжать качественный clf clf.человек clf.приходить переводчик преподавание переводчик indx
семья это счастие любовь и удача	семья это счастье любовь и удача	семья это счастье любить счастье удача
видео мы отправлять несколько человек давать он весь посмотреть	видео отправлять.сообщениеpl все даватьpl смотреть2	видео отправлять.сообщение pl все просить смотреть смотреть2
когда в школа глухой работать переводчик то они согласный приходить	школа глухой работать переводчик гап гап	школа глухой работать есть переводчик 1ps приходить гап
наш настроение легко портиться из-за политика из-за другой ситуация отношение	мы очень легко грустить влиять 1ps страдать политика другой ситуацияpl	мы очень легко грустить влиять 1ps страдать политика другой случай pl
на сегодняшний форум проблема со связь	сегодня сегодня проблема2 интернет связать	здесь сегодня <dact> проблема2 интернет связь
не столько я себя плохо чувствовать сколько хотеть оставаться дом и никто не видеть	1ps н-е только2 чувствовать плохо.себя.чувствовать	1ps н-е только2 чувствовать плохо.себя.чувствовать плюс 1ps не хотеть никто видеть
если у вы появляться ещ вопрос писать мы в комментарий под видео	если у 2ps появляться вопрос писать комментарии	или случай ещё есть вопрос писать комментарии
а за остальной деньги куда пойти	а деньги куда все	а indx нужно <nums> успех <nums> еще деньги clf clf.много clf clf.деньги куда
понимать нужно делать шаг для это развитие а не то как вы требовать давать и далеко сидеть сложа рука	шагpl это развитие понимать не.нужно <dact> 2ps требовать 1ps будет слож	шаг pl <dact> необходимость <dact> это развитие понимать 2ps желание требовать <dact>
отставать	думать	отстать
ваш обычный еда не мочь так как я виноград гилберт	ваш обычный еда не мочь 1ps виноград илберт не мочь	еда обычный простой все4 не мочь это 1ps виноград <dact>
она посмотреть вверх и увидеть красивый голубой небо и облако	clf clf.смотреть clf.внизу видеть красивый голубой небо обл	clf clf.посмотреть clf.вверх красивый <dact> небо голубой и <dact> clf clf.облако clf.pl
из москва	москва	и-з москва
умный	умный	умный
если она не давать то она начинать гавкать	если давать 3ps гавканье	если давать 3ps 1ps 3ps гавканье
и тот быть тоже быть ехать грязный рука	еда грязный	еда грязный
белый и зеленый чай зеленый кофе содержать природный кофеин который повышать влияние адреналин на жировой ткань в результат гореть наш жир	белый2 зеленый <dact> зеленый <dact> природа давать <dact> это давать энергия	белый2 зеленый <dact> зеленый <dact> составлять природа давать <dact> это давать энергия увеличение <dact> <dact> ткань получаться poss 2ps <dact> огонь
можно еще кондиционер в вид пена он легкий сглаживать волос и придавать легкий увлажнение	можно <dact> пена легко clf clf.сглаживать clf clf.волосы	можно <dact> <dact> пена легко clf clf.сглаживать clf clf.волосы легко увлажнение
опыт помогать я чувствовать себя уверенный в себя	опыт помогать 1ps 1ps уверенный себя чувствовать	indx 1ps чувствовать себя уверенный
ну да давать премия вс правильно	премия 3ps давать 1ps	премия 3ps давать 1ps
терпимость это то что сегодня так не хватать	терпимость это сегодня нужно сегодня не.хватать	терпимость это сегодня нужно pl
май самый т плый весенний месяц	<dact> сам2 весенний месяц	<dact> всегда теплота в.течение весна теплота
всего-навсего студент	маловажный2 студент2	маловажный хз2 студент2
в полдень студент распахнуть окно и выглядывать в сад	день <nums> день студент2 открытый окно открытый видеть	день <nums> день студент2 открытый окно открытый видеть
осень ребенок надевать штаны сапог куртка и брать зонтик	осень дети одеться брюки сапоги куртка зонт <dact>	осень дети одеться брюки сапоги куртка зонт <dact>
луиза очень привязываться к девочка но удерживать она не мочь не иметь право	<dact> учить2 придумывать девочка н-о держать не мочь нет	<dact> учить сильный любить девочка н-о держать не мочь нет3 право
антон пылесосить ковер и выкидывать мусор а дедушка например помогать бабушка и заниматься внук учить антон играть в шахматы а катя читать е любимый сказка	<dact> пылесосить ковер выкидывать пример дедушка 1ps помогать 3ps бабушка2	<dact> пылесосить плоский <dact> выкидывать пример дедушка 1ps помогать 3ps бабушка2 заниматься <dact> если трудно обучать2 <dact> обучать2 шахматы <dact> читать любить сказка
двигаться в правильный направление в пищевод это называться пищевой желоб	clf clf.двигаться направление правильный еда жевать2 внутренний все	clf clf.двигаться направление правильный еда жевать2 внутренний <dact> назвать еда <dact>
хотеть немного подробно вы рассказывать чтобы кто-то быть полезный	желание подробный рассказывать открытый изучать все быть полезный	немного желание подробный рассказывать открытый изучать все быть полезный
я уметь красиво писать	1ps знать красивый писать	1ps красивый написать мочь2
на поляна нет гриб	территория гриб нет2	территория гриб нет2
разрушать	разрушение2	разрушение2
однако встречаться различный проблема и непонятно как двигаться далеко	дальше тупикpl как	дальше тупик pl как
если сдерживаться невозможно у вы быть пара минута чтобы добегать до туалет и расслабляться	если сдерживаться бесполезный у 2ps есть <nums> минута что доходить будет	сжатый не.мочь clf clf.чуть минута.две минута.три давать что до туалет бег2 место все4
но ты спас я жизнь	н-о 2ps спасать 1ps жизнь	н-о 2ps спасать poss 1ps жизнь
тот же фамилия и у бабушка с дедушка ведь она переходить папа от они	одинаковый фамилия бабушка2 дедушка родители папа потому что папа перед	одинаковый фамилия бабушка2 дедушка poss 3ps родители папа потому что папа передать 3ps передать 1ps фамилия свой родители
я тоже хотеть носить красивый платье	1ps тоже желание носить платье красивый	1ps тоже желание носить платье красивый
поэтому запасаться полезный продукт и поехать	это собирать2 подготовка собирать2 и поехать	это собирать2 подготовка собирать2 и начинать
ну весь золушка теперь ты мочь ехать во дворец	все золушка теперь 2ps мочь уезжать дворец	все сейчас <dact> 2ps мочь уезжать дворец
очень мало человек заниматься программирование	программирование дефицит <nums> человек все2	программирование дефицит <nums> человек все2
также плохой труба и канализация где протекать плохой вода и из кран так же бежать плохой и ржавый вода	плохой вода трубаpl плохой вода clf clf.течь clf 	это плохой вода труба <dact> clf clf.течь clf.из clf.крана грязный ржавчина труба pl плохой <dact>
я нравиться общаться с людьмиб интересно узнавать что случаться	1ps нравиться человек интересный узнать что случай	1ps pl нравиться общаться человек интересный узнать случай что
весь время они играть и гулять вместе как друг мальчик заболевать	всегда игра гулять гулять вместеpl друг мальчик болезнь	вместе pl игра гулять разнообразный вместе pl вдруг 2ps мальчик болезнь
бывать что катя и антон ссориться но потом обязательно мириться	быть <dact> <dact> <dact> ссориться н-о потом будет мириться	<dact> <dact> быть pl ссориться быть pl н-о потом обязанность мириться
когда человек начинать кашлять хвататься за горло что мы должный сделать как должный помогать	человекpl кашлять2 задыхаться2 кашлять2 что мы должен 1ps помогать	человек начать кашлять2 задыхаться2 кашлять2 что мы должен 1ps помогать 3ps какой должен был
этот чай работать как антиоксидант бороться с некоторый процесс в организм	это <dact> работать апетит апетит и вместе акцентировать.	<dact> indx работать2 как <dact> как против организм что есть
он слушать когда говорить и понимать	3ps слушать говорить2 понимать	3ps слушать говорить2 indx понятый
главное чтобы он действительно представлять то как бы он хотеть чтобы быть	главный 3ps представить3 2ps желание что был	главный 3ps должен представить3 <dact> 3ps желание что был
второй совсем не принимать	второй совсем не.знать	следующий3 второй совсем взять не
они часто приходить на берег и плавать прыгать в вода	двое часто приходить плавание clf clf.берега clf.прыгать	двое часто приходить clf clf.берег плавание clf clf.с clf.берега clf.прыгать clf.в clf.воду
я любить красный помада	1ps любить красный губная помада	губная помада 1ps любить красный
я не хотеть выступать на концерт	концерт сцена принимающий участие не.хотеть	концерт сцена принимающий участие не.хотеть
без вы у я на сердце тоска	без 2ps сердце чувствовать грусть	без 2ps сердце чувствовать грусть
желчь	желчь	<dact>
давать разбираться зачем мы есть	пробовать исследовать почему мы еда почему	пробовать исследовать почему мы еда почему
привет друг я звать андрей	привет другpl 1ps имя а-й	привет друг pl 1ps имя а-й
каков причина этот проблема у глухой	причина2 глухой indx	проблема2 глухой indx причина какой
старуха удивляться	старый удивительный	удивление старый
достоинстно	достоинность	гордость
сейчас я заниматься инскусственный интеллект т е то как он распознавать жестовый язык и переводить он в текст такой вот у я тема	1ps сейчас 1ps заниматься <dact> это <dact> это 3ps воспринимать.в.сторону	indx тема2 какой это <dact> какой это <dact> <dact> это для2 poss 3ps <dact> говорить на жестовом языке 3ps воспринимать 1ps говорить на жестовом языке 3ps воспринимать 1ps переключаться написать использовать искусственный.интеллект внутри тема2
переходить к тема	переходить тема2	clf clf.отодвинуть тема2
счастливый	счастливый	счастливый
каков причина	причина2 какой	причина2 pl какой
пожалуйста научать жестовый язык	пожалуйста учить3 1ps пожалуйста жестовый язык	пожалуйста <nums> учить3 1ps мочь2 школа пожалуйста жестовый язык
и на розовый куст на самый верхний побег начало распускаться великолепный роза	и clf clf.кусты clf.кусты clf.кусты clf	кусты розовый цветок кусты clf clf.побег clf.растения начинать clf clf.распускается clf.цветок красивый шикарный цветок
если быть учитель наставник то продвижение быстрый будет потому что ты учить и сопровождать да	если быть учитель наставник то продвижение быстрый будет если 2ps 	быстрый будет карьера indx опыт есть 3ps учить 1ps 1ps заместитель да
вопрос такой вы уже переболеть	вопрос 3ps заболеть уже	вопрос 3ps 1ps заболеть уже
если бы я не становиться переводчик я заниматься бы продажа быть бы экономист	если 1ps переводчик нет2 был продажа экономика2	если 1ps переводчик нет2 б-ы был продажа экономика2
аплодисменты	аплодисменты	аплодисменты
бывать низко температура	температура повышать	ниже быть <nums> ниже
главное смотреть на то как выглядеть волос и что вы нужно на каждый день	главный вы смотреть clf clf.волосы clf.тяжелые что вы необходимо	главный вы смотреть чувствовать clf clf.волосы clf.тяжелые что вы необходимость каждый день
далеко договариваться с государство а оно просить взятка	дальше договариваться государство а <dact> пожалуйста	следующий пример государство 1ps pl договор государство беседовать взятка
как пить капсула фуд контрол	как таблетка <dact> <dact>	как таблетка <dact> <dact> как
при пережевывание еда распадаться на кусочек чтобы организм быть легко нужный слюна она смешиваться с еда и расщеплять она	когда2 жевать2 еда clf clf.кусок clf.с	когда2 жевать2 еда clf clf.распадаться clf.кусок что организм легко2 нужно <dact> clf clf.смаковать еда жевать2 исчезать
весь крепко и крепко прижиматься соловей к шип и песня он звучать весь громко и громко ибо он петь о зарождение страсть в душа мужчина и девушка	все clf clf.шип clf.протыкает clf.тело птицы	птица2 clf clf.прижиматься clf.телом clf.к clf.шипу песня кричать птица2 это о-н песня о появляться эмоция все включено мужчина2 и девочка
я хотеть выступать на концерт	1ps желание принимающий участие концерт	1ps желание принимающий участие концерт
почему выбирать это число	число выбрать почему	число выбрать почему
в концертный зал кто-то быть	концерт зал кто есть	концерт зал <dact> кто есть indx
лето расти вкусный яблоко	лето расти вкусный2	лето расти вкусный яблоко clf clf.есть clf.яблоки
вот значит ствол дерево это возникать проблема нужно узнавать каков е причина и какой оказываться последствие	indx дерево clf clf.ствол clf.дерева это проблема2 indx причин	indx indx дерево clf clf.ствол clf.дерева indx проблема2 indx причина <nums> что какой pl indx результат итог
они предлагать такой рабочий место куда человек с инвалидность не мочь устраиваться	уже предлагать такой место куда человек инвалид вступить не мочь поступать	3ps предлагать такой работа место куда инвалид вступить просто не.мочь
они уничтожать танк противник с то чтобы обеспечивать дальнейший продвижение пехота	танк уничтовать танк что двигаться	танк уничтовать что clf clf.люди двигаться
мой мама ой мой папа закаляться не знать каждый день чтобы не заболевать обливаться хлодный вода ну знать стоять под холодный душ	poss мама poss 1 папа не знать каждый день что болезнь нет clf clf.	poss1 мама poss1 папа <dact> не знать каждый день что болезнь нет clf clf.обиваться холодно не знать душ
пока	пока	прощаться
трудный	трудный	трудный
я часто слушать история на ваш канал и теперь решать поделиться свой	часто слушать история poss 2ps программа и решать разделение 2ps делиться 1ps	часто слушать история poss 2ps программа и решать разделение 1ps делиться 3ps собственный
в итог никакой поступление энергия нет	и это множественный электричество такой не иметь	и ждать2 электричество тратить успех тоже нет2 запас
рубль нет даайт посмотреть что туда входить	<nums> рубль нейтр.имп да говорить indx смотреть	<nums> рубль не <nums> рубль нейтр.имп смотреть входить.во.что-то что
я тоже понимать что уже не мочь без он	1ps сам2 думать что без 3ps не мочь	1ps сам2 думать что без 3ps 1ps не мочь
поэтому она открывать страница в Instagram о рыжий кот где рассказывать история о бобо который недавно выходить на пенсия	поэтому она открывать instagram2 страница instagram2 страница рассказывать	поэтому рыжий кошка3 <dact> открывать instagram2 страница рассказывать история <dact> 3ps совсем недавно уже выходить пенсия
если не получаться то во время реанимация инородный тело оно пройти в один из бронх и тогда один из легкий смочь дышать дыхание будет частичный не в полный объем	если успех не.мочь.сделать indx и clf clf.с	если получаться нет т-о в-о время реанимация может.быть поперхнуться бронхи <dact> clf clf.инородное clf.тело clf.сдвинуться удача <nums> легкое удача пустой будет дышать н-е полный н-о часть будет
крепко прижиматься ко я милый соловушка не то день прийти рано чем заалеть роза	imp приближенный clf clf.шип clf.протыкает clf.тело	clf clf.тело дорогой птица2 если день начинать заранее красный изменять не.успевать
он не уметь кататься на лыжа	о-н мальчик не мочь кататься.на.лыжах	о-н мальчик 3ps не мочь не знать кататься.на.лыжах
и вот мы сыграть свадьба и я переезжать к он у они быть три комната в квартира	вместе свадьба 1ps переезд у 3ps indx все включено квартира у 3ps все	вместе свадьба 1ps переезд у 3ps indx все включено квартира у 3ps был <nums> комната pl clf clf.комнаты
мочь быть будет кто-то с кохлеарный имлант	мочь быть кто кто кохлеарный.имплант разнообразие2	может быть кто есть к-и кохлеарный.имплант
обязательно быть ошибка а расчет примерный	должен первый ошибка а расчет примерный	должен ошибка pl clf clf.уровень clf.разный примерно сравнить пример рассказывать
раздражать этот бесконечный ветер	раздражать всегда ветер раздражать	раздражать всегда ветер раздражать
чтобы не заболевать я делать зарядка	что болезнь нет 1ps делать зарядка2	что болезнь нет 1ps делать зарядка2
кролик обращаться а я рано не быть настоящий	кролик обратиться раньше2 не.был настоящий не.был	кролик обратиться indx раньше2 не.был настоящий не.был
лето можно играть в песочница лепить кулич из песок	лето мочь игра песок пирожокpl делать песок	лето мочь игра песок делать пирожок pl делать песок
я самый трусливый и самый слабый из весь животное	1ps самый3 трус и самый3 слабый2 и-з живот	1ps самый3 трус и самый3 слабый2 и-з животное pl
главный задача угвеод обеспечивать мы быстрый энергия во-первых белок и жир организм усваивать в определенный количество а угвеода приниматься в любой количество	главный 2ps помогать 1ps быстрый электричество почему пример <dact> <dact> это внутри.с	<dact> это 3ps давать 1ps быстрый электричество почему пример <dact> <dact> это внутри.себя воспринимать точно сколько 1ps нужно лишний не.нужно воспринимать а <dact> все любой получать pl воспринимать
он ездить на автобус	автобус о-н еда clf clf.идти clf.на clf	о-н ехать.на.транспорте автобус автобус
если у вы волос торчать то и вы хотеть они сглаживать то нужно использовать коллаген шелк кератин и белок	если у 2ps волосы clf clf.волосы clf.торчат clf clf	если у 2ps pl волосы clf clf.волосы clf.торчат clf clf.волосы clf.торчат желание clf clf.сглаживать что что необходимость использовать <dact> <dact> <dact> <dact>
живот сообщать мозг и он понимать ой да да да где здесь туалет	животное говорить мозг это indx подсказывать 1ps где тоже	живот indx сообщение 1ps мозг возникать понимать да pl тулет искать
тема будет очень интересный о переводчик какой он должный быть какой качество должный обладать и т д	тема2 какой будет интересный о.чем переводчик какой должен бы	тема2 интересный о человек2 переводчик какой должен был какой качественный какой правила2 что пример список2 исследовать будет
потому что когда вы начинать делать что-то в ущерб себя вы начинать ненавидеть тот для кто это делать	например 1ps себе заставлять3pl похоже отдавать.себя себе заставлять3	например 1ps себе заставлять3 pl похоже 1ps начинать человек pl ненавидеть2
он встряхиваться отчего мышонок упасть на земля	о-н вдруг мышь2 о-т упасть куда	трястись2 мышь2 падать2 н-а земля
и давать направление действительно нужно развивать	и это направление действительно нужно развивать	и это направление действительно нужно развивать
я премия не давать	премия давать 1ps не был	премия давать 1ps не был
чуть в легкий не попадать	clf clf.чуть легкие попал clf clf.чуть	indx clf clf.чуть легкие попал clf clf.чуть
вот например весь знать проблема глухой работа и т д	пример проблема2 глухой все знать проблема2 работать перечислять2	1ps пример проблема2 глухой все самый знать проблема2 работать перечислять2
нужно делать шаг	это что делать делать	необходимость шаг pl
сжимание стенка называться перистальтика	clf clf.стенки clf.сжиматься назвать <dact>	clf clf.стенки clf.пищевода clf.сжиматься назвать <dact>
а человек заложник потом отпускать	брать.за.руку уводить потом уводить	брать.за.руку уводить да
сразу невозможно быть получать	indx <nums> невозможный получать	indx <nums> любой толпа получать не.мочь.сделать
в трудовой ресурс зарплата такой же как в материальный	труд зарплата такойже indx материал2pl	зарплата труд тоже indx мочь ждать
мой брат не любить шоколад с то момент как отравляться он	poss брат н-е не.любить шоколад тоже отравиться	когда2 3ps poss <nums> брат яд шоколад после2 это не.любить шоколад
я весь этот три день участвовать рассказывать защищать свой проект сказать что у я уже быть письмо поддержка например от музей балл быстро подсчитывать и это быть успех	день все это indx 1ps делать 1ps рассказывать 2ps защищать 1ps финал защищать	день <nums> это indx 1ps делать 1ps рассказывать 2ps защищать 3ps финал защищать 1ps рассказывать 2ps что 1ps indx <dact> есть 3ps поддерживать 1ps печать indx спонсор все есть известный быстрый <dact> и 1ps успех
смотреть группа из человек это мало человек это много	смотреть <nums> человек <nums> человек мало <nums> человек множество толпа	смотреть indx <nums> человек группа <nums> человек мало <nums> человек множество толпа
урок называться наш дружный семья	урок назвать poss 1ps дружба семья	урок назвать poss 1ps pl дружба семья
кто там в новосибирск быть	кто indx новосибирск есть	кто indx indx новосибирск есть
а проблема то в то что мы мочь говорить на жестовый один рука а в англия человек так не мочь	проблема2 indx англия жест только2 fs clf.использовать clf 	indx проблема2 indx англия жест только2 fs clf clf.использовать clf.обе clf.руки два говорить на жестовом языке рука один говорить на жестовом языке мочь2 телефон говорить на жестовом языке мочь2 англия нет3
ну если ничто нет давать варить каша из топор	н-у если ничего нет2 нейтр.имп. пробовать готов	н-у если ничего нет2 нейтр.имп. пробовать готовить <dact> и-з топор2
первый раз укусить начинать жевать	первый clf clf.укусить начать жевать2	когда2 первый clf clf.укусить начать жевать2
температура то повышаться то понижаться снег мочь то неделя лежать а мочь мало и потом растаивать	температура понижать <nums> неделя понижать уже <nums> неделя <nums> неделя мочь	температура повышать быть понижать clf clf.толстый clf.слой <dact> <nums> неделя мочь меньше таять
главный дед мороз удивленно посмотреть на он и сказать теперь ты быть не маленький дед мороз а лесной	главный 3ps видеть главный видеть дать 3ps дед.мороз поменять <dact> что	дед.мороз видеть главный видеть удивление дать был <dact> дед.мороз поменять <dact> что лес точно
медвежонок ларсить жить на северный полюс вместе с мама и папа	медведь имя <dact> жизнь место clf clf.шар clf.шар clf	медведь имя <dact> жизнь место clf clf.шар indx северный вместе родители
в это дом не бывать гость	это дом гость ноль	это дом гость ноль
ошибка считать что можно похудеть быть принимать капсула лежать на диван и ходить по тысяча шаг в день каждый день увеличивать это количество на шаг	читать лекарство лежать лекарство тысяч <dact> ходить нужно каждый день	все думать лекарство лежать лекарство уже <nums> тысяч <dact> ходить нужно каждый день увеличивать <nums> ходить увеличивать
пожалуйста выбирать то кто по ваш мнение входить в сообщество глухой	пожалуйста выбрать кто 2ps pl мнение входить мир2 глухой	пожалуйста выбрать pl поставить.галочку выбрать poss 2ps мнение что включать мир2 глухой
весь спрашивать почему на юг так популярный одежда защищать от ветер	все спрашивать о территория популярный одежда2 защита ветер	все спрашивать 1ps ю-г популярный clf clf.толстая clf.одежда защита ветер
я в близкий время хотеть сделать опрос о то кто желать становиться глухой экскурсовод экскурсовод для глухой	1ps близкий время будет опрос кто желать глухой экскурсовод	1ps будет опрос 3ps pl кто желание переводчик глухой <dact> проводить кто желание есть желание
проходить день неделя а она весь мечтать	проходить день проходить неделя а 3ps мечтать желание	желание проходить день проходить неделя
ясный	яркий солнце светлый	яркий солнце светлый
да он мастер форма это у он отнимать нельзя но быть ли у он чувство	да 3ps мастер песня это у 3ps чувствовать общий есть нет2 у 3ps чувствовать	да 3ps мастер песня голос2 качественный н-о интересный у 3ps чувствовать общий есть нет2
у они бюджет быть от сто двести тысяча и высоко	бюджет множественный о-т разный	3ps финансирование2 о-т <nums> тысяча pl и выше
в инкубатор быть свой плюс ты давать помещение оказывать финансовый и юридический помощь оборудование техника много что давать	инкубатор есть собственный плюс 2ps давать комната2 мочь 2ps да	это <dact> попадать indx <dact> плюс pl что 3ps давать 2ps комната2 мочь 3ps давать 2ps бухгалтерия юрист помощь множественный что 1ps давать 2ps мочь механизм компьютер
ладно сам доносить	пусть сам2 clf clf.нести clf.на clf.плече	пусть сам2 clf clf.нести clf.на clf.плече
маша не спать весь ночь она готовиться к экзамен	<dact> н-е спать не все нет с утра до вечера ночь 3ps	<dact> н-е спать не все нет с утра до вечера ночь 3ps подготовка экзамен
в магазин быть сыр	магазин есть магазин <dact>	магазин <dact> магазин есть
очень много глухой готовый заниматься л гкие дело	человек много человекpl так будет делать хуже дело	человек много человек pl так будет делать хуже дело
но с ветер конечно по-другому	ветер случай другой	ветер случай другой будет
гаснуть	clf clf.свет clf.выключить	clf clf.свет clf.выключить
энергия давать позитивный мышление и жизненный тонус	энергия давать мысль плюсpl и жизнь возбуждение	энергия давать 1ps мысль плюс pl и жизнь возбуждение
но это мой жизнь	н-о poss 1ps жизнь тоже	это 1ps жизнь
если я король то ты очень храбрый принц это лес	если 1ps король 2ps очень смелый лес2	если 1ps король т-о 2ps очень смелый <dact> лес2
эхо понести этот трель к свой багряный пещера в гора и разбудить спать там пастух	приветствовать clf clf.эхо clf.распространяется гора clf clf.	приветствовать clf clf.эхо clf.распространяется гора clf clf.эхо clf.распространяется звук clf clf.эхо clf.распространяется кто пастух indx спать слышать просыпаться
в результат слышать ребенок не давать жестовый язык	слышащий дети2 давать нет2	какой это н-е давать нет слышащий дети2 жестовый.язык
как это из топор можно сваривать каша	как и-з топор2 мочь готовить и-з топор2	как <dact> и-з топор2 мочь готовить вопрос
животное встречаться влюбляться с первый взгляд подружиться и помогать друг друг выздоравливать	животное встречаться влюбляться первый взгляд.друг.на.друга друж	такой встреча <nums> 3ps 3ps животное2 <dact> влюбиться первый взгляд.друг.на.друга дружба друг.друга помогать 3ps 1ps pl здоровый
быть тот кто смотреть и говорить ну это же так просто и легко не смотреть	есть кто смотреть н-у простой легко2 смотреть не.нужно	мочь кто смотреть н-у простой легко2 все4 поэтому кто смотреть не.нужно
нечестный	честный не	честный нет
рано он называться иср а сейчас название новый истый	раньше был <dact> сейчас3 новый <dact>	раньше был <dact> сейчас3 новый <dact>
фрукт уже практически нет	плодpl мало уже	плод pl мало уже
весь ребенок начинать изучать жестовый язык	все дети2 начинать изучать.на.жестовом.языке	ребенок уже начать задавать.вопросы жестовый язык
вдалеке увидеть деревня	смотреть деревня далеко3	смотреть деревня далеко3
сам смотреть что вы надо что не надо	сам2 смотреть как нужно что poss 2ps pl что не.нужно	сам2 смотреть как нужно что poss 2ps pl что не.нужно
и он высовываться из окно и сорвать она	студент2 clf clf.высовываться clf.из clf.окна ср	студент2 clf clf.высовывать clf.голову clf.из clf.окна окно clf clf.высовываться clf.из clf.окна срывать clf clf.держать clf.цветок clf.в clf.руке
она быть такой же злой и вредный	девочка такой.же злость вред	характер такой.же злость вред
вы так беседовать со свой ребенок	2ps pl тоже беседовать	тоже 2ps pl беседовать собственность дети2
делать нужно в определенный модификация	н-о только2 делать в странный модификация	н-о только2 делать в странный мода
следующий человек потерять слух во взрослый возраст	следующий2 человекpl кто оглохнуть взрослый	следующий2 человек pl кто оглохнуть взрослый
например первый это грант	пример первый <dact>	пример первый <dact>
мальчик ловить и крупный рыба	мальчик ловить великий рыба2	мальчик ловить великий рыба2
первый это хлопок по спина	первый clf clf.человек clf.выбить clf.инородное	первый 1ps нужно спина clf clf.человек clf.выбить clf.инородное clf.тело
как сделать я	как делать 1ps	как делать 1ps
работа в команда похожий на профессиональный спорт	работать2 команда одинаковый слышащий спорт2	indx и почему 1ps говорить объяснять команда indx такой профессионал спорт
здравствовать	здравствуйте	здравствуйте
на этот земля не расти ни кукуруза ни картошка	земля расти ничего3 картофель расти не мочь	земля территория расти <dact> картофель расти не мочь
что мы нужно сделать	что мы делать	что мы нужно делать
я быть делиться свой опыт	1ps будет делить объяснять опыт	1ps свой опыт будет 1ps делить советовать рассказ кто 3ps pl жестовый.язык
друг	друг	друг
а у старушка весь быть	а у 3ps старый все есть	3ps у 3ps старый все есть
наслаждение	наслаждаться	наслаждаться
я любить сосиска	1ps сосиска 1ps любить	1ps сосиски 1ps любить
ветер здесь до м с	ветер до <nums> м секунда	ветер до <nums> м секунда
нужно изменять себя внутри переставать заставлять себя и жертвовать себя	нужно внутри.себя изменять себе заставлять3 нет2	нужно внутри.себя изменять себе заставлять3 нет2 отдавать.себя нет2
необходимо привозить оборудование который предоставлять электричество	необходимость приостановитьсяpl что необходимость электричество	необходимость собственность clf clf.взять clf.привезти оборудование электричество деньги clf clf.взять clf.привезти необходимость доставка
ругать	ругать2	ругать2
падать снег и быть темно	идет снег был ночь	идет снег был ночь
грубый	грубый	грубый
слышать всегда смотреть на то какой вы команда если сильный вы быть работать	слышащий 2ps pl видеть команда если сильный будет делать	слышащий 3ps pl видеть команда какой 3ps команда сильный будет делать
получаться столбец не связанный слабо связанный средне связанный сильно связанный	получаться <nums> столбец связать пустой н-о так.себе связ	получать2 clf 4.столбца первый здесь связать пустой так.себе связать норма нет2 столбец связать есть н-о так.себе слабый связать есть средний связать крепкий
попадать	попадать	попасть clf clf.что
я начинать этот занимать в год и обучение там длиться день с утро до самый вечер	1ps начинать был <nums> день с утра до вечера учиться	1ps начинать был <nums> indx день <nums> учиться с утра до вечера учиться
и он вернуться к себя в комната вытаскивать большой запылить книга и приниматься она читать	студент2 обратимый домой комната собственный комната вытаскивать clf clf 	студент2 обратимый домой комната собственный книга clf clf.книга clf.большая clf.тяжелая протирать <dact> протирать и clf clf.открыть clf.книгу начинать взглянуть читать
отношение быть меняться	отношение менять менять	отношения изменять будет
можно ли в ваш регион подписывать соглашен о трудоустройство человек с инвалидность в другой организация	можно н-о poss 2ps регион подписывать соглашение2 о трудоустройство	можно л-и poss 2ps регион подпись <dact> о трудоустройство инвалид другой организация
он никогда не быть в турция	о-н никогда2 турция не был	3ps никогда2 турция не был
или если у вы быть знакомый который знать финский жестовый язык передавать он этот информация пожалуйста	или у есть знакомый 2ps знать жестовый.язык2 финляндия 2ps переда	или у есть знакомый 3ps знать жестовый.язык2 финляндия 2ps передавать пост2 видеть отправлять пожалуйста
подымать	подымать	clf clf.поднимать
я видеть что вокруг много молодой человек школьник который не думать куда поступать а думать куда пойти они друг или куда направлять они родитель	1ps замечать вокруг много молодой и школа думать куда поступать брать	так 1ps замечать вокруг много молодой и школа думать 1ps куда поступать брать.пример.с друг родители 3ps заставлять2 1ps
у третьяков быть хобби он быть меценат и оплачивать строительство школа для глухой ребенок выделять целый тысяча на это и в год построить трехэтажный здание школа	третий еда <dact> <dact> <dact> деньги финансирование забота семья школа для	и <dact> 3ps <nums> дело хобби 3ps деньги финансирование забота семья школа для глухой <nums> тысяч отправить з-а строить clf clf.здание строить <nums> год этаж <nums> здание
тамара долго идти по почти непролазный дорога и вдруг увидеть дым из труба один из дом она обрадоваться побежать подавать и весь грязный добираться наконец до это дом	<dact> медленно дорога был неподалекий н-о глаз замечать дым	ходить медленно место дорога был неприятный стремный н-о глаз indx дом дым и видеть бежать2 падать2 плакать тело грязь добраться до это indx дом
мы радоваться когда гладить котенок и чужой слово влиять на наш настроение	мы радоваться что видеть например кот indx что гладить2 слово чужой сказать	когда2 мы радоваться радоваться что видеть например кот indx что гладить2 слово чужой сказать 1ps влиять 1ps настроение
хм а кто же будет кучер	хм а кто будет кучер	задуматься кто 3ps будет кучер
там быть мой кворки нажимать создавать кворк	indx <dact> indx <dact> создать <dact> <dact>	indx <dact> <dact> indx строка создать <dact>
смотреть как он обучать что нужно добавлять	смотреть обучать2 что необходимость добавить	<dact> clf clf.человек обучать2 что необходимость добавить
мой отец бояться мачеха	poss 1ps папа мама второй бояться3 бояться3	poss 1ps папа мама второй бояться3 бояться
к сожаление фотография прабабушка и прадедушка родитель бабушка и дедушка не сохраняться поэтому на это дерево весь начинаться с бабушка и дедушка	сожаление фотокамера <dact> дедушка <dact> дедушка отсутствие сохранять отсутств	сожаление фотокамера <dact> дедушка <dact> бабушка2 отсутствие 3ps родители 3ps бабушка2 дедушка отсутствие сохранять отсутствие поэтому indx дерево все начать бабушка2 и дедушка
ну в общий это вс что я хотеть сказать	все результат 1ps желание сказать	все результат 1ps желание сказать
это желание будет помогать копить	это желание 1ps помогать 1ps копить будет	это желание 1ps помогать 1ps копить будет
ленивый	ленивый2	ленивый2
муравьед любить кушать насекомое авокадо цитрусовый	<dact> <dact> еда обожать2 еда обожать2	3ps еда <dact>- паук <dact> апельсин <dact> еда обожать2
зато рейтинг высокий и много заказ а у он все заказ быть отзыв	3ps высший р-е заказpl много у 3ps pl заказ бытьpl <dact>	3ps высший р-е- заказ pl много у 3ps <nums> 3ps заказ быть pl <dact>
когда у маленький дед мороз весь подарок быть готовый остальной вс думать что снова надо будет ехать дарить ребенок подарок возвращаться домой что это очень скучно	если подарок похоже готово clf clf.поездом ехать.	3ps подарок похоже готово clf clf.коробки clf.расставить готово это ждать все дед.мороз неинтересно опять2 не.хотеть ехать.поездом дети подарок pl назад домой не.хотеть похоже неинтересно поэтому думать обсудить пусть
еще раз хотеть сказать что каждый момент свой жизнь нужно наполнять радость	еще раз хотеть сказать каждый момент свой жизнь нужно наполнять рад	еще раз хотеть сказать каждый момент свой жизнь нужно наполнять радость
костик и мишка сказать тоже где ты быть что с ты приключаться рассказывать	<dact> <dact> сказать 1ps тоже где был 2ps был случай что 2ps рассказывать 1ps	еще <dact> <dact> 3ps спрашивать 1ps тоже где был случай что 2ps рассказывать 1ps
семен по путь с работа забирать дочка из садик и к ужин они всегда быть дом но не в этот злосчастный день	работать2 дочь работать2 и-з дети <dact> и вечер все	<dact> работать clf clf.человек clf.идет 1ps забирать 3ps дочь и-з дети <dact> и вечер всегда2 домой еда стол н-о попадать день беда
и по свисток начинать собирать человек на съезд в москва начинаться беготня в общий постанавливать собирать человек в москва в июль год	и свистеть начинать clf clf.люди clf.собираются	и свистеть начинать clf clf.люди clf.собираются clf.в clf.одном clf.месте съезд москва попал беготня общий постановить clf clf.люди clf.приходят москва <dact> <nums> год2 <dact> clf clf.люди clf.приходят
как жираф	жираф похоже	жираф похоже
смотреть результат быть	смотреть есть результат	смотреть иметь результат
краудфандинг	<dact>	<dact>
когда вы себя насиловать унижать у вы нет уважение к себя вы не в состояние что-то давать	похоже отдавать.себя себе унижение унижение 1ps нет2 похоже 1ps не	похоже отдавать.себя себе унижение себе уважать 1ps нет2 похоже 1ps не мочь давать pl
однажды они зайти в лесной глушь	вдруг лес глушь clf clf.запрыгнуть clf.круглый clf	вдруг лес внутри
мама он сразу начало учить я жизнь что я должный муж беспрекословно во весь слушаться и сразу выполнять весь что он требовать	мама 3ps начинать 1ps учить2 1ps жизнь что 1ps муж должен был послушный	мама poss 3ps начинать 3ps учить2 1ps <dact> жизнь что 1ps муж должен был послушный2 3ps заказывать 1ps 3ps приказать 1ps 3ps требовать 1ps 1ps выполнить
я работать уже давно с начало создание адаптиса	1ps работать2 долго <nums> начинать создание адаптиса	1ps стаж2 давно все4 работать2 когда начинать создавать2 sn
без знание жестовый язык этот ребенок не являться CODA	жестовый.язык не.знать кода нет indx	жестовый.язык не.знать считать2 н-е кода нет 3ps
нордис в г новосибирск	<dact> новосибирск здесь	<dact> новосибирск здесь
благодаря плодоножка вишня в организм не накапливаться лишний жидкость а в жировой ткань активизироваться процесс микроциркуляция	благодаря плодоножка вишня внутри.себя очищение жидкий лишний внутри	еще clf clf.плодоножка indx indx н-е 3ps давать 1ps добавлять жидкий лишний внутри.себя и активный промежуток.времени управлять <dact> внутри.себя ткань
они поехать в приют и предлагать вместе с они собака пойти на долгий прогулка	3ps поехать место <dact> и предлагать вместе собака и гулять долго	<dact> поехать место <dact> и нейтр.имп вместе собака poss 3ps забирать и гулять долго
я вс учитывать и тогда я получать удовольствие от работа потому что она быть в кайф	1ps всегда2 и 1ps когда2 1ps работать потому что 1ps кайф	1ps все считать2 и 3ps pl удовольствие 1ps работать почему indx кайф3
вообще весь человек журналист ленивый	все журналист все человекpl ленивый все	все журналист все человек pl ленивый все
я удаваться оформлять кредит благодаря то что в банк к мой проблема относиться с понимание	1ps мочь2 оформлять кредит почему благодаря понимать 1ps проблема2 есть	1ps мочь2 оформлять кредит почему благодаря понимать 1ps есть проблема2
готовый	готовый	готовый
потом няня становиться жалко кролик но доктор сказать надо сжигать и давать новый	потом няня2 смотреть жаль врач2 спрашивать доктор2 indx 	потом 2ps няня2 смотреть жаль врач2 спрашивать доктор2 indx кролик indx так огонь новый давать
но вы сам понимать что связь у я не так много но то не менее шанс уже быть у вы быть шанс получать помощь	н-о у 1ps понимать что зависеть есть 2ps pl есть зависеть indx есть	н-о у 1ps понимать2 зависеть мало временный есть 2ps pl <dact> есть радость 2ps спрашивать 1ps
и плюс всегда развиваться учиться идти вперед	и плюс всегда развивать учиться идти всегда	и плюс всегда развитие учиться идти.вперед
и если милиция я не находить	если милиция 1ps успех нет	вдруг indx милиция 1ps 1ps искать 3ps успех нет
спонсор готовый платить я выполнять проект в это город нехватать мыло я сообщать спонсор получать мыло и раздавать	платить2 согласие платить2 согласие проект выполнять2 город indx не.хвата	платить2 согласие постоянный платить2 1ps проект выполнять сдать pl город indx не.хватать 1ps объявлять 3ps clf clf.взять clf.мыло сдать pl
сейчас глухой начинать активно заниматься индивидуальный предпринимательство и это плюс потому что они становиться независимый	все и-п сам2 начинать indx предпринимательство свой плюс не	все и-п мочь indx плюс потому что свой зависимость не
они наблюдать и чувствовать что необходимо создавать общество для ребенок CODA	3ps pl наблюдать 1ps pl дети2 слышащий кода	смотреть pl чувствовать что нужно создавать2 общество группа для кода
либо где можно находить спонсор чтобы получаться сокращать количество деньги и расход быть по ноль	или где можно находить спонсор что составлять получаться деньги кратко расход	или где можно находить спонсор что составлять получаться деньги кратко расходы ничего
кто-то печ т торт кто-то фотографировать работать в такси и развивать автопарк кто-то заниматься ремонт	кто торт печь кто фотография2 достигать кто такси подготовка автомобиль <dact>	кто торт печь кто фотография2 достигать кто такси подготовка автомобиль <dact> развитие кто ремонт
я очень рад что быть выбор профессия специальность	1ps очень радостный есть выбор профессия специальность	1ps очень радостный есть выбор профессия специальность
она помогать она заниматься научать готовить печь шить они часто вместе гулять ходить в музей и на выставка	помощь 3ps учить2 1ps готовить пирожки пирог шить вместе часто	помощь учиться 1ps учить2 3ps готовить пирожки пирог шить вместе часто прогулка музей выставка смотреть2
также от до процент калорийность идти на пищеварение	еще о-т <nums> до <nums> процент калория все4	еще о-т <nums> до <nums> процент <dact> мы тратить н-а пищеварение
многий из они еще и работать переводчик в вуз	много все переводчик много посетить <dact> переводить работать посещать.туда.сюда	и 3ps pl переводчик много посетить <dact> переводить работать посещать.и.то.и.это
встреча	встретить	встретить
я говорить что нужно сюда а он в другой место доставлять	1ps 1ps доставка 3ps 3ps 1ps 3ps не indx	1ps не 1ps indx доставка 3ps 1ps 3ps не indx
гость ничто не купить к чай	гостьpl ничего3 деньги не чай	гость pl ничего3 деньги не <dact> чай indx
это он собака	это собака2	это poss 3ps собака
да да постоянно калька	да да калька2pl	да да калька2 pl
я состоять в ассоциация слышать гид	1ps есть включать содружество слышащий включать	1ps есть включать содружество <dact> проводить <dact> слышащий включать
дом красиво украшаться весь делать друг друг подарок вместе играть и танцевать	дом красивый украшать все делать подарок подарок все семья игра танцевать	дом красивый украшать все делать подарок подарок2 все семья игра танцевать
мы отда м себя полностью и жд м любовь к себя	отдавать.себя ждать2 любить себе	отдавать.себя pl ждать2 любить себе
важный использовать бальзам если волос повреждать и торчать	clf clf.волосы clf.повреждены получается clf clf.вол	бывает clf clf.волосы clf.торчат получаться clf clf.волосы clf.повреждены волосы clf clf.волосы clf.повреждены получается clf clf.волосы clf.повреждены сломанный clf clf.волосы clf.торчат получаться
не ловко ну да ладно	неудобно2 ладно	неудобно2 ладно
как это на жестовый передавать	жест как передавать	жест как передавать
солдат посолить и снова попробовать	солдат немного солить новый пробовать	солдат немного солить новый пробовать
ведь это самый настоящий кошмар	потому что сам2 настоящий	страшный будет
допускать к вы приш л пациент со свой проблема и вы выяснять что у он быть психосоматический влияние	случай пример человек clf clf.человек clf.приближается у 3ps есть	случай пример человек clf clf.человек clf.приближается у 3ps есть проблема2 3ps видеть что у 3ps есть мозг <dact>
выделять деньги на школа	деньги на школа	школа clf clf.выделять clf.деньги
когда вы чувствовать себя хорошо и человек вокруг вы чувствовать себя хорошо уровень жизнь качественно поменяться	лучше 2ps хорошо 1ps человекpl все себе чувствовать хорошо жизнь уровень измен	1ps хорошо 1ps делать для 3ps pl <dact> себе приятный все себе чувствовать хорошо жизнь уровень изменять
давать поговорить по душа	нейтр.имп. общаться душа	нейтр.имп. общаться душа
у он быть одежда	одежда2 у 3ps есть	одежда2 нет одежда2 у 3ps есть
на следующий день они вдвоем встречаться с орел	следующий день двое встреча орел встреча	следующий день двое встреча орел встреча
я из семья глухой мой мама и папа глухой	1ps семья глухой poss 1ps мама папа глухой	1ps семья глухой poss 1ps мама папа глухой
спрашивать у лощадь как быть всегда вместе с мальчик	спрашивать мальчик вместе лошадь был вместе	обратиться мальчик вместе indx нет
когда быть просить мало деньги то и грант вы легко давать	грант мало деньги мало просить деньги мало грант легко	<dact> деньги мало просить деньги мало грант легко
находить	найти	находить
састье слышать	счастье слышать	счастье слышать
говорить	говорить	говорить
вога кормить себя плюс еще инвалид кормить	<dact> себя 1ps кормить еще инвалид кормить 3ps	indx <dact> себя 1ps кормить 1ps плюс еще инвалид кормить 3ps
когда знать что быть резерв на душа спокойно а когда потратиться переживать лишний раз вдруг увольнять	если знать есть хорошо душа спокойный еда когда2 по	знать копить indx 1ps на.душе.спокойно 1ps выбросить переживать вдруг уволить думать лишний
я всерьез это никогда не воспринимать но когда увидеть он возмужать взрослый почувствовать как защемлять сердце	1ps <dact> воспринимать нет и видеть сегодня2 взрослый 1ps нравиться	1ps <dact> серьезно воспринимать нет и видеть сегодня2 взрослый 1ps нравиться
мужчина схватывать чемодан в один рука сумка в другой и на ход потому что поезд уже начинать медленно ехать вскакивать на ступенька	мужчина2 clf clf.сумка clf.взять сумка clf clf	мужчина2 взять <dact> clf clf.сумка clf.взять сумка clf clf.бежать что поезд начать clf поезд ехать и clf clf.человек clf.прыгнуть ступенька
деньги я не давать но выписывать рекомендательный письмо письмо поддержка начальство поставлять печать	1ps согласиться письмо поддерживать согласиться заполнять согласиться печать качественный clf clf	1ps согласиться письмо поддерживать согласиться заполнять администратор печать качественный clf clf.держать clf.письмо clf.в clf.руке хорошо
в конец июнь начало июль уже созревать вишня черешня абрикос	июнь начинать июнь начинать июль готовый вишня <dact> <dact>	clf clf.плод clf.pl готовый последний3 июнь начинать июль indx вишня <dact> <dact>
сахар в кровь расти а вслед за этот расти и количество инсулин	сахар кровь расти уже множественный <dact> это расти множественный <dact>	сахар в красный увеличивать множественный и плюс множественный <dact> добавлять pl
не то чтобы он не хотеть я слушать но просто он вс это быть безразлично	не.хотеть н-о простой н-о простой 3ps pl все	мальчик н-е только не хотеть 1ps слушать тоже 3ps безразличие
он думать лишь о музыка а всякий знать что искусство эгоистично	3ps думать только2 о музыка все знать искусство только2 думать	3ps думать только2 о музыка все знать искусство indx только2 думать о себя pl
а ефросинья петровна надо я видно просыпаться от это грохот	и <dact> <dact> открытый.глаза	<dact> <dact> открыть.глаза
можно делать сковоречник	мочь делать сковоречник	мочь делать дом для птица
когда реб нок чувствовать что он не один он начинать по-другому относиться к свой родитель открываться он	когда2 ребенок чувствовать что н-е <nums> нет а другой родител	1ps <nums> нет 1ps чувствовать открытый и начать относиться папа п-о другой
очень довольный	очень довольно	очень довольно
за этот три год в инкубатор вы расти и становиться сильный но кроме этот пункт который я уже объяснять быть и другой способ получать деньги на свой проект	год <nums> выпускать2 <dact> расти уже сильный выпускать2 это все есть друг	год <nums> выпускать2 <dact> родиться больше уже сильный выпускать2 это множественный мочь другой талантливый 2ps проект есть все включено делать карьера
я звать елена	1ps имя <dact>	здравствуйте 1ps имя <dact>
утом помогать запускать обмен вещество на максимальный скорость работа щитовидный железа давать прилив энергия и хороший настроение а вечер наоборот успокаивать настраивать на хороший сон и защищать от обжорство и ускорять расход жир из наш запас	утро помогать 1ps clf clf.организм clf.процесс clf.начать	утро помогать 1ps clf clf.организм clf.процесс clf.начать максимум скорость clf clf.организм clf.процесс clf.работать работать2 щитовидная.железа ш clf clf.щитовидная clf clf.организм clf.процесс энергия clf clf.организм clf.процесс и настроение хорошо а вечер2 наоборот успокоить слабость спать хорошо защищать о-т еда pl нервный отсутствие <dact> тратить запас быстрый
ну вот же у ты готовый ответ	н-у у 2ps готовый ответ	готовый ответ
я заканчивать учиться пойти работать туда где быть глухой	1ps учиться учиться поступать2 работать2 место глухой	1ps учиться конец поступать2 работать2 место глухой
вот	здесь	здесь
потом я подзывать свой ребенок который знать жестовый язык он весело подходить ко я	потом это подзывать дети2 первый знать жестовый язык слышащий	потом ребенок poss 1ps ребенок нейтр.имп ребенок оживленный нейтр.имп 1ps жестовый язык знать clf clf.подойти нейтр.имп
начинать дуть ветер	ветерpl начинать	ветер pl начинать
в холодильник нет еда	холодно indx еда нет2	холодно indx еда нет2 ноль скелет2
что же делать	что делать	что делать
ты бояться даже ветер	2ps бояться даже ветер	2ps бояться даже ветер
в понедельник мы быть проводить прямой эфир	у 1ps будет понедельник завтра будет проводить п-э	у 1ps будет понедельник завтра будет проводить п-э
Ещ дедушка с антон хотеть сделать семейный древо	еще дедушка вместе делать дерево ветвьpl семья	еще дедушка вместе <dact> желание делать дерево ветвь pl семья
семья это сложный но жить один невозможно	семья это сложный н-о счастье жить <nums> невозможный	семья это сложный н-о счастье жить <nums> невозможный
конечно нужно чтобы кто-то вызывать скорый помощь	если мочь2 человекpl вызывать скорый помощь	конечно нужно чтобы кто заметить indx вызвать <nums>
тома находить в себя сила прощать муж хоть и даваться она это нелегко	<dact> успех себя clf clf.сидеть clf.на clf.пле	<dact> успех себя сильный прощать2 мальчик муж действительно был тяжелый
работник китайский магазин в нью-йорк взять он в магазин и он оставаться там на год	работник китайский магазин в нью-йорк взять н-а	магазин нью-йорк китай магазин взять и оставить <nums> время
вечерний капсула пролонгировать лимфодренажный эффект получать на первый шаг	вечер капсула2 жидкий жидкий жидкий получить clf clf 	вечер капсула indx <dact> жидкий 1 <dact> был 3ps давать 1ps indx управлять clf clf.выравнивать
да вредить	наносить.вред	наносить.вред
борис джонсон болеть в март	<dact> <dact> заболеть был <dact> заболеть <dact>	3ps <dact> <dact> заболеть был <dact>
сестра пойти на бал а я нет	сестра уезжать бал 1ps не будет	сестра двое уезжать бал 1ps не будет
в мой город нет аэропорт	poss 1ps город аэропорт нет2	poss 1ps город аэропорт нет2
мочь быть я смочь взламывать сенсор ааа он на работа	мочь быть 1ps мочь2 взламывать с.собой работа	мочь 1ps мочь сломать clf clf.сенсор clf clf.стучать 2ps работать2 занято
узкий	узкий	clf clf.тонкий
вот уже не думать что из топор такой вкусный каша мочь получаться	и думать не что и-з топор2 так2 вкусный2 мо	<dact> у-ж н-е думать не что и-з топор2 так хорошо <dact> мочь готовить
вс вокруг начинать зеленеть и цвести птица прилетать	все круговое.движение начать зеленый и птица	все круговое движение начать зеленый начать цветы птица
а однажды в ателье зайти женщина в возраст она долго рассматривать я задавать вопрос а потом сказать что быть бы неплохо она сын познакомиться с такой девушка	а вдруг ателье женщина2 старший был женщина2 долго был 3ps	и вдруг 3ps входить 1ps женщина возраст и пристальный взгляд 3ps вопрос.задавать 1ps потом 3ps отвечать 1ps б-ы poss 3ps сын 1ps девочка соединять знакомить
девочка она не понравиться	девочка мама смотреть не нравиться	девочка мама смотреть не нравиться
в предыдущий видео мы говорить о то что мы потреблять слишком много разный вкусный еда но организм не мочь потратить весь этот энергия	вообще прошлое видео2 говорить 2ps потреблять множественный лишний не.	давно видео2 мы 1ps рассказывать 2ps что еда множественный еда некоторый вкусный а тратить indx электричество внутри.себя не мочь уже
легкий	легко	легко2
познакомиться я предлагать и я становиться заниматься резьба	знакомить 1ps предлагать 1ps заниматься резьба2 карьера	знакомить 3ps предлагать 1ps 1ps заниматься резьба2 карьера
когда в первый раз участвовать совсем ничто не понятно	первый раз участвовать не понимать	раз <nums> куда не понимать первый второй третий
у крашеный волос цвет исчезать	волосы что крашеный цвет3 исчезновение	волосы что крашеный цвет3 исчезновение
давать ждать	нейтр.имп ждать2	нейтр.имп ждать2
вопрос вводить ли свой ребенок в сообщество глухой приводить ли на праздник участвовать ли в мероприятие	вопрос вводить свой дети глухой внутри свой глухой дети привести	вопрос 2ps свой дети 2ps включать мир2 глухой проводить мероприятие праздник участвовать
самый плохой что это в климат краснодарский край это ветер	сам2 плохой что климат краснодар территория ветер	плохой крупный что indx климат краснодар территория ветер
спать далеко это я дениска	продолжать indx дяска indx	какой спать продолжать 1ps <dact> имя
я заходить в строка продавец туда заходить	1ps зайти строка продавец	1ps зайти строка продавец
рассказывать про человек про то как я здесь рождаться и про вс остальное	рассказывать человекpl тоже 1ps рождаться уже	будет о человек pl разнообразие 1ps здесь родить много разнообразие рассказывать будет
весь и у я быть удобный защитный средство	все4 и себя есть удобный защитный средство	все4 и себя есть удобный защита прятать защита
весь другой животное очень взволноваться	все другой животноеpl очень волнение2	все другой животное pl очень волнение2
он просто оглушать я	слышать звук	слышать звук
после урок идти к ребята	когда2 урок идти ребята	поздно урок приходить дети <dact>
так вот третьяков построить трехэтажный здание школа а рядом еще больница построить	и т-о создать2 этаж <nums> и больница2 был стро	3ps т-у создавать2 этаж <nums> и больница2 был строить clf clf.расположение clf.объектов clf.в clf.пространстве
почему это слово код являться популярный во весь мир	почему это слово <dact> популярный2 все мир2	почему это слово <dact> популярный2 <nums> называть мир2
хорошо пока	хорошо пока хорошо	хорошо пока хорошо
мать обещание не сдерживать и после окончание школа оля уезжать в чужой город и там и оставаться	мама обещание алкоголь нет проходить школа <dact> уезжать другой чужой город	мама 3ps алкоголь и проходить школа <dact> уезжать другой чужой город и indx зафиксировать
к пример я экскурсовод кто не приходить человек так называть экскурсант	представление 1ps <dact> clf clf.движется clf.loc кто clf clf	представление 1ps <dact> clf clf.толпа clf.движется clf.loc 3ps имя называть <dact>
я под кровать за двадцатьлет не то что созревать я там вполне перезревать	1ps лежать <nums> время 1ps детство уже уже взрослый будет	1ps лежать <nums> время 1ps детство уже уже изменять взрослый будет
это федеральный государственный образовательный стандарт	это федеральный государственный образовательный стандарт	это poss 3ps государство печать наука, образование
я с она очень согласный	1ps очень хорошо вместе работать	1ps мнение согласие
можно слепить снеговик	мочь делать снеговик шарpl	мочь делать <dact> шар pl
я думать что такой курс давать глухой новый возможность	1ps думать что курс давать новый возможность для глухой	1ps думать что курс давать новый возможность для глухой
в-третьих это огромный количество энергия который обрушиваться на мы и мы не знать куда он потратить	третий еще это большой clf clf.поступление clf.энергии	третий еще это большой clf clf.поступление clf.энергии электричество это множественный clf clf.поступление clf.энергии 1ps тратить куда трудно
мой учитель сказать женщина у она дочь со сломать позвоночник что это не причина отказываться от радость плакать не нужно	poss учитель сказать женщина рядом poss 3ps дочь 3ps сломать позвоночник	мой учитель имя дактилирование 3ps был сказать у 3ps был дочь с позвоночник сломаться 3ps говорить это н-е причина н-е радоваться плакать не
в магазин нет сыр	магазин <dact> нет2	магазин <dact> нет2
не предлагать я ехать	просить уважать 1ps предлагать 1ps еда не.нужно	просить уважать 1ps 1ps предлагать 3ps еда не.нужно
общий представление о белок жир и углевод мы мочь получать в лаборатория однако у мы в организм весь устраивать намного интересный и сложный	представление о <dact> <dact> все лаборатория и 1ps внутри.себя все еще	это общий мочь получать только2 лаборатория poss 1ps внутри.себя все еще интересный и сложный
нет хорошо так мой подруга быстро бегать не уметь	нет хорошо 1ps друг быстрый бежать не знать	не poss 1ps друг быстрый бежать не знать
утро принимать два капсула после еда вечер за минута до ужин	утро еда все4 капсула2 вечер2 будет еда з	утро еда все4 clf clf.принять clf.две clf.капсулы вечер2 будет еда <dact> з-а <nums> минута будет еда
они бродить до утро по улица а потом поехать на вокзал и снова они место быть рядом	бродить до утро clf clf.два clf.человека clf.	согласиться прогулка с.вечер.до.утро потом вместе clf clf.два clf.человека clf.идут вокзал2 и попадать место сосед
мы не смочь поймать рыба	1ps рыба схватить не мочь	1ps рыба схватить не мочь
у я двое слышать ребенок	1ps дети2 слышащий	1ps у 1ps дети2 <nums> слышащий
мы вс восстанавливать	мы все восстанавливать	не.переживать
давать подумать о то что вы написать	нейтр.имп думать о что написать	поэтому нейтр.имп строчка pl думать
в магазин пойти	магазин ходить	магазин пойти
они собираться и общаться на жестовый язык	дети2 собираться говорить на жестовом языке	3ps собираться проводить говорить.на.жестовом.языке
я только русский и английский язык	1ps <nums> русский 2	1ps <nums> русский английский 2
следующий тот кто не знать жестовый язык	следующий2 кто не знать жестовый.язык2 не.знать	следующий2 кто жест не знать
я быть в италия	италия2 был	италия2 1ps был
саша сломать нога из-за это сегодня не прийти на день рождение	<dact> сломать ноги и сегодня2 н-е приходить2 не.	<dact> <dact> сломанный это 3ps не мочь приезжать день.рождения clf clf.человек clf.прийти день.рождения
жизнь закалять и я благодарный весь кто поддерживать я в непростой время помогать подсказывать	жизнь 3ps учить2 1ps хорошо все кто был сосед 3ps поддерживать 1ps	жизнь 3ps учить2 1ps 1ps благодарение все кто был сосед 3ps поддерживать 1ps 1ps тяжелый время 3ps подсказывать 1ps
да раз в неделя заниматься	<nums> раз <nums> неделя <nums> раз <nums> учиться	indx неделя <nums> раз <nums> учиться
здравствовать	здравствуйте	приветствовать здравствуйте
я она слушаться потому что считать что она становиться я мама я она даже так называть	1ps думать 3ps одинаковый 1ps мама 1ps иметь тема2 тоже	1ps согласиться надеяться <dact> <dact> poss 1ps мама тоже 1ps иметь тема <dact>
еще когда человек полностью задыхаться мы останавливаться	еще когда человек полный задыхаться полный задыхаться полный тихий	еще когда человек полный задыхаться2 останавливаться полный тихий
совсем отрицательно	следующий3 совсем отрицать	следующий3 совсем отрицать
здесь мы также продолжать заниматься в различный кружок проводить тренинг и разнообразный мастер-класс	здесь тоже продолжать разнообразие кружок мастер класс разнообразие	здесь тоже продолжать разнообразие кружок мастер класс <dact> разнообразие
либо родитель не отдавать все себя ребенок и не объяснять смысл слово на жестовый язык	или родной отдавать.всего.себя говорить на жестовом языке рассказ	или родной отдавать.всего.себя говорить на жестовом языке рассказывать мысль слово
к сожаление не весь семья такой дружный	сожаление все семья такой дружба	сожаление все семья такой дружба
я не мочь ты отпускать поэтому я купить билет до твой город	1ps не мочь 2ps кормить билет до poss 2ps город	1ps 2ps свобода не мочь 1ps кормить билет до poss 2ps город
только вы так странно одевать	одежда3 одежда3 странный	одежда3 просматривать одежда3 странный
где-то или месяц	месяц <nums> месяц <nums> месяц 3	месяц <nums> месяц <nums> месяц <nums> месяц 3
вода в речка быть прозрачный так что можно быть увидеть камень на день	вода река прозрачный видеть камень четко	вода река прозрачный видеть камень четко
у мы с другой быть секрет друг от друг	вместе друг секрет иметь секрет	1ps друг вдвоем секрет иметь делить ноль
у я в план в дальнейший объявлять о возможность проведень курс обучение	у 1ps есть план дальнейший объявлять о возможность уже обучать2 <dact>	у 1ps есть план 1ps уже ранее объявлять о poss 1ps план обучать2 <dact> обучать2
весь человек разный у весь разный работа и характер разный то что я объяснять это не готовый формула успех главное я давать вы правильный направление	человекpl разный работать2 разный характер разный поэтому 1ps объяснять это готов	человек pl разный работать2 разный характер разный поэтому 1ps объяснять это готовый2 успех все4 1ps выполнять главный направление правильный clf clf.двигаться clf.в clf.направлении
нужно что-то решать но я действительно не знать с что начинать	думать решать нужно действительно 1ps не.знать что с что начать	думать решать нужно действительно 1ps не.знать что с что начать
мы договариваться встречаться в определенный день я приходить рассказывать о свой проект и сказать что деньги пока на он нет	1ps договариваться встречаться2 когда2 1ps приходить 1ps рассказывать 2ps проект	1ps договор число попадать 1ps <dact> приходить это встречаться 1ps разговаривать2 да согласие 1ps что проект 1ps есть а деньги временный нет2 1ps желание <dact> <dact> деньги зависеть
я не понимать математика	математика 1ps не понимать нет3	математика 1ps не понимать нет3
неполный блокада дыхательный путь	не полный останавливаться дышать	н-е полный не останавливаться дышать
наверное вы подумать что быть лишний окошко	наверное думать всегда лишний	наверное думать еще лишний
настоящий	настоящий	настоящий
бабушка и дедушка родитель папа а мама и папа родитель катя и антон	бабушка2 дедушка родители папа папа мама папа родители poss 3ps <dact> <dact>	бабушка2 дедушка это родители папа poss 3ps мама папа родители poss 3ps <dact> <dact>
еще он замечать бабочка медвежонок никогда не видеть ничто такой же яркий разноцветный красивый и удивительный	еще замечать бабочка2 раньше медведь видеть никогда похоже	еще замечать бабочка2 раньше медведь видеть никогда похоже яркий цвет разный и красивый удивительный
весь животное в лес смеяться над мышонок	все животноеpl лес2 смеяться угрожать2 мышь2	все животное pl лес2 смеяться угрожать2 <dact> мышь2
мелкий	мелкий2	мелкий2
они связываться со спонсор который попросить предоставлять скидка или раздавать мыло бесплатно чтобы ребенок использовать он для мытье рука	контактироватьpl <dact> спонсор контактироватьpl согласие бесплатный раздавать мыло сдать	уже контактировать pl <dact> спонсор контактировать pl просить 3ps скидка или бесплатный раздавать мыло сдать pl дети2 умыть руки использовать pl уже
следующий акселератор	следущий3 <dact>	следущий3 <dact>
общий	общий	общий
мой попугай любить человек	poss попугай любить человекpl	poss попугай <dact> любить человек pl
акцентировать внимание именно на это	акцентировать.внимание дети2	<nums> до у 1ps 1ps интерес акцентировать.внимание дети2
вот и первый рыбка ерш	первый рыба2 ловить	первый рыба2 ловить <dact>
мой бабушка любить гулять ночь	poss бабушка любить гулять ночь	poss бабушка любить гулять ночь
получаться что один апсула с утро уменьшать аппетит особенно тяга к сладкий защищать от развитие метаболический синдром инсулинорезистентность а в дальнейший сахарный диабет усиливать эффект насыщение и защищать от повторный набор вес	успех капсула утро уменьшать2 еще не.хотеть отдельный	успех капсула утро indx уменьшать2 следующий3 еда еще не.хотеть отдельный2 сладкий indx желание нет2 и защищать о-т о-т воспринимать и сахар <dact> конец и сильный увеличивать чувствовать сытый и защищать о-т обратимый вес увеличивать
я обожать что в мой работа нет однообразие всегда разный место человек информация посещать разный мероприятие	обожать2 что 1ps однообразно так нет2 всегда2 разный место человекpl информация	обожать2 что 1ps однообразно так нет2 всегда2 разный место человек pl информация разный посещать.туда.сюда разный
антон настоящий старший брат он всегда защищать свой маленький сестра если кто-то в школа иногда пытаться е обижать	<dact> настоящий старший брат 3ps всегда защита свой маленький сестра	<dact> настоящий старший брат 3ps всегда защита свой маленький сестра забота случай что школа быть pl 3ps кто обида дразнить
и я становиться интересно быть ли подобный в москва	1ps очень интересный был случай москва какой	1ps интересный москва здесь есть отсутствие
человек не носить это платье потому что оно мало	человекpl носить платье почему н-е мало	человек pl н-е носить это платье почему это indx мало маленький3
здесь африка	здесь африка2	здесь африка2
мочь быть чтобы деньги оставаться на потом но на самый дело весь человек разный и у каждый быть свой причина	мочь быть что думать оставить желание н-о так суд человек	мочь быть что думать копить оставить желание н-о так 2ps pl человек pl разный причина свой pl внутрь
мучение	страдание	страдание
тонкий	худой2	худой2
да	д-а	да
в интернет быть список конкурс в свой город	интернет список соренование свой город	интернет список соренование свой город
рано быть такой автомобиль красивый длинный с олень на капот	раньше был автомобиль красивый clf clf.длинный clf.один clf 	<dact> раньше красивый clf clf.длинный clf.автомобиль clf clf.фары <dact> олень clf clf.олень clf.лапы clf clf.олень clf.стоит
она начало что-то говорить да неожиданно замолчать	начинать девочка это случай неожиданно2 молчать	3ps <dact> девочка рассказывать случай неожиданно2 молчать
несколько год назад у она к сожаление умирать мама	некоторый год назад2 девочка девочка смерть мама смерть жалость	несколько лет назад2 девочка poss 3ps мама смерть жалость
пожалуйста помогать мы кто если не вы	пожалуйста помогать 2ps если 2ps кто дефицит	1ps просить 2ps помогать 2ps 1ps если 2ps кто дефицит
у мы весь переводчик первый категория и постоянно повышать свой квалификация	у 1ps переводчик все первый категория и всегда расти карьера учить	у 1ps переводчик все первый <dact> и всегда расти карьера учить карьера всегда
он быть старый я на год и наш отношение быть довольно странный	3ps был старший 1ps н-а <nums> лет и взаимоотношения был странный	мальчик 3ps был старший 1ps н-а <nums> лет и взаимоотношения был странный
человек говорить не мочь но он модевать покачать голова	человек говорить не.мочь.сделать голова как голова как голова	человек говорить не.мочь.сделать голова как голова кивать хорошо
невозможно	не.мочь.сделать	невозможный
правильно	правильный	правильный
код собираться вперемешку	кода собрание смешанный	кода собрание смешанный
он так бояться	3ps так страх	о-н так страх
я подумать у я получаться резьба заниматься	1ps думать у 1ps есть резьба2 был	поэтому 1ps думать резьба2 успех как
в будущее мир глухой исчезать или нет	будущее мир2 глухой исчезновение будет или не.будет	думать будущее мир2 глухой исчезновение будет или не.будет
это не мой тема но я смотреть немного в будущее	это poss 1ps тема но 1ps смотреть чуть-чуть будущее	это н-е poss 1ps тема но 1ps смотреть чуть-чуть будущее
это прекрасный возможность для человек с различный ментальный заболевание кто действительно не мочь трудоустраиваться и он нужно постоянный сопровождение	это отличный возможность для человекpl разныйpl умственный заболевание кто не	это отличный возможность для человек pl разный pl умственный заболевание кто не мочь разделять не мочь трудоустройство 3ps нужно следующий следить
множество человек	множество человекpl	множественный человек pl
не понимать почему кушать что	2ps не понимать почему еда что	2ps не понимать почему еда что
похоже откусывать сэндвич	например еда съесть <dact>	похоже <dact> clf clf.сэндвич clf.откусить
и вот изображение стекло запотевать он начинать он протирать и когда протирать начинать проявляться картина то что он хотеть	и видеть clf clf.изображение clf.размытое начинать вы	пример clf clf.изображение clf.размытое начинать вытирать когда2 вытирать появляться картина рисовать это соответствовать indx что 3ps желание похоже 1ps исправлять 3ps
также здесь рассказывать об история общество глухой о то откуда возникать жестовый язык	и 3ps включать похоже 2ps рассказывать 2ps история общество глухой о	и 3ps включать похоже 1ps рассказывать 2ps история раньше глухой общество жестовый.язык2 возникать
если не помогать снова производить хлопок пока ни получаться	если успех не.хотеть новый clf clf.человек clf.	бесполезный новый clf clf.человек clf.выбить clf.инородное clf.тело clf clf.человек clf.выбить clf.инородное clf.тело чередовать глаза clf clf.инородный clf.предмет clf.вытолкнуть нужно
когда медвежонок просыпаться папа не быть только вода повсюду	когда2 медведь просыпаться папа не только вода повсюду	когда медведь маленький3 проснуться папа пусто повсюду вода
получаться при минимальный увеличение жир обмен вещество в организм замедляться в раз	получаться clf clf.чуть увеличение <dact> увеличение clf clf.чуть	получаться clf clf.чуть увеличение <dact> увеличение clf clf.чуть получаться clf clf.огранизм clf.процесс <dact> медленно в 1.5 <dact> медленно
я переводить различный пара мероприятие	1ps переводчик разный пара мероприятиеpl	1ps переводчик разный урок мероприятие
а к кто обращаться	а обращаться кто	а обращаться кто
я обязанный знать военный дело	1ps обязанность знать военный дело	1ps обязанность знать правила военный дело
древолаз очень токсичный и бывать разный цветок желтый темно-зеленый красный черный но самый опасный золотой	clf clf.лягушка clf.взбирается clf.по clf.	clf clf.лягушка clf.взбирается clf.по clf.дереву у 3ps есть вредить есть бывает видеть цвет3 желтый темный зеленый красный синий черный н-о сам2 опасный зеленый цвет3 золотой
вопрос кто входить в сообщество глухой	вопрос кто входить мир2 глухой	вопрос кто включать мир2 глухой внутри
четвертый ваш мнение	четвертый poss 2ps мнение	четвертый poss 2ps мнение
веко защекотать слезинка когда поезд тронуться но вдруг дверь в купе открываться и входить роберт	слеза поезд clf clf.поезд clf.трогается clf clf.двер	слеза поезд clf clf.поезд clf.трогается вдруг clf clf.двери clf.купе clf.открываются мальчик clf clf.человек clf.идет то.же.самое <dact>
создавать	создать2	собирать
а куст кричать соловей чтобы тот еще крепко прижиматься к шип	кусты clf clf.кусты кричать птица2 imp держать clf	кусты clf clf.кусты кричать птица2 imp держать clf clf.тельце clf.птицы imp
мочь быть у вы быть какой-либо вопрос или хотеть подробность я готовый вы отвечать спрашивать	мочь быть у ps2 есть вопрос подробный мочь ответ спросить 1ps	может.быть у ps2 есть вопрос подробный мочь ответ спросить 1ps
нападать	нападать	напатать
из жир так же как и из белок строиться клетка оболочка мембрана без жир не образовываться поэтому часть жир идти на строительство этот мембрана и не давать мы энергия	<dact> тоже строить клетки.организма без <dact> это часть это будет использова	<dact> indx и <dact> тоже строить клетки.организма indx без clf clf.оболочка clf.клетки это делать и-з <dact> это отдельный <dact> будет использовать строить clf clf.оболочка clf.клетки и электричество 3ps давать 1ps нет indx половина убирать
сделать такой ступенька на память красота	делать такой ступенька clf clf.ступенька clf.на памятник	это indx ступенька был собирать памятник красивый
быть много направление где можно себя применять физкультура преподавание разный направление быть	есть физкультура направление считать3 преподавание направление считать3 любой	1ps какой физкультура направление считать3 преподавание направление считать3 любой разнообразие3 куда все есть
а инвалид нужно быть обязательно давать путевка дом отдых специальный больница	и а инвалид должен быть обязательный выгодаpl отдых дать домpl	и а инвалид так нужно платить pl должен первый путевка отдых дать дом pl отдых дать специальность больница2
мой текущий рабочий деятельность мочь продолжаться до но вдруг я узнавать о болезнь или что-то случаться	1ps деятельность работать2 быть хорошо мочь до <nums> мочь быть	сейчас 1ps деятельность работать2 быть хорошо мочь до <nums> мочь быть н-о узнать болезнь что случай
это значит настоящий поэтому сейчас он не мочь	это настоящий сейчас не мочь	это настоящий сейчас не мочь
поэтому я хотя и оробеть но не до конец и весь продолжать посматривать на ефросинья петровна что же она будет делать далеко	поэтому 1ps думать оробеть не до конец и видеть продолжать след	1ps пока 1ps чуть-чуть страшный чуть-чуть взглянуть бабушка взглянуть делать что интересный взглянуть
по разный причина по сложный работа по ещ какой-то причина просто не хотеть	разнообразие причина сложный работа потому что причина сложный работа не.хотеть	разнообразие причина сложный условие труд ещё что-то не.хотеть
в сентябрь обычно тоже жарко	сентябрь тоже	сентябрь indx тоже
внешний	внешний	внешний
я не знать испанский язык	1ps испания2 язык не знать	1ps испания2 язык 1ps не знать
я относиться ко весь одинаково хорошо	1ps все так хорошо отношение	1ps все так хорошо отношение
один ребенок будет смотреть но он это не нужно	смотреть не.нужно	смотреть не.нужно
мой профессия интересный и необычный	poss 1ps профессия2 интересный необычный	poss 1ps профессия переводчик интересный необычный
однажды тамара присниться сон забросить деревня а там дочка и она звать тамара и просить скоро она находить	когда2 был сон присниться сон clf clf.спрыгнуть деревня	и однажды 3ps девочка сон изгой2 деревня и дочь кто кричать мама pl быстрый 1ps успех
в-третьих помимо углевод жир и белок пища давать наш организм витамин и минерал который регулировать различный процесс	третий еда <dact> <dact> <dact> еда 1ps давать 1ps плюс полезный	третий еда <dact> <dact> <dact> вместе еще 3ps давать 1ps плюс полезный <dact> что метаболизм правильно работать внутри.себя все
я должный уметь командовать отряд	1ps должен быть знать группа первый	1ps нужно знать пример группа военный руководить
я часто пропускать школа из-за то что сидеть с младший сестра	1ps часто прогуливать школа почему 1ps сидеть младший сестра	1ps часто прогуливать школа почему 1ps сидеть вместе младший сестра
общий	общий	общий2
что хотеть сказать	что желание сказать	желание сказать
бывать что в связь с погодный условие обледеневать и оборваться провод но опять же такой случаться редко	быть попадать дождь быть мороз дождь быть clf clf.провод clf	быть попадать <dact> мороз дождь быть clf clf.провод clf.pl провод clf clf.провод clf.порваться редко
так быть всегда сказать сова и это никогда не изменяться	разговаривать2 всегда ладно думать изменять не.будет2	разговаривать2 <dact> пусть всегда ладно думать изменять не.будет2 ладно
через ассоциация мы постараться сделать так чтобы вы в свой город например в новосибирск находить филиал этот ассоциация и приходить туда	а в содружество 1ps будет раздавать2 все это 3ps адрес свой ново	1ps через содружество 3ps 1ps адрес список 1ps будет раздавать2 все это 3ps адрес свой новосибирск 3ps другой город будет приходить2
а если я не прийти домой папа и мама обязательно сообщать в милиция	если 1ps домой не будет мама предупредить милиция предупредить	1ps домой не будет родители должен полицейский милиция предупредить
лето сам себя нужно купаться	лето сам2 нужно купаться	indx лето обязательный купаться
когда наступать ночь они отдыхать	когда ночь начало отдых	когда ночь начало отдых
это я очень нужно потому что я получать различный информация о музей город благодаря этот организация	1ps быть включать indx быть различный организация получать информация все получать в	1ps indx быть включать это нужда indx различный pl получать информация все получать вечный у 3ps содружество перечислять2 получать2 indx быть музей работать2 включать indx город страна indx 1ps вечный
мать девочка сильно выпивать после развод с отец и оля всегда сторониться ребята чувствовать себя обделять	мама девочка будет проходить развод папа папа папа 3ps <dact> 3ps всегда2 <nums> алкогол	мама poss 3ps девочка проходить расстаться папа сильный алкоголь и <dact> 3ps всегда2 <nums> лишний2
вода холодный или ты притворяться	вода холодный или 2ps притворяться	вода холодный или 2ps притворяться
благодаря вот этот механизм ускоряться снижение вес	благодарение это indx собирать успех вес худеть	благодарение это indx собирать indx успех вес худеть
дочка сидеть зажиматься в угол	дочь сидеть угол прятать	дочь сидеть угол прятать
но иногда смотреть на человек и думать что у он жировой запас даже слишком много и пора останавливаться	о-н человекpl смотреть человекpl думать у 3ps жировые.запас	видеть человек 3ps <dact> жировые.запасы куда хватит конец
мы с она знакомый	вместе знакомить	1ps pl вместе знакомый
я приходить в тот школа в который среди слышать ребенок быть код приходить туда смотреть помогать	1ps приходить школа indx включать слышащий дети2 смотреть2 всегда	кто indx дети слышащий кода включать 1ps помогать 3ps 1ps приходить 3ps проводить indx приходить смотреть indx
обнимать и до следующий встреча	обнимать до следующий встреча	обнимать все до следующий встреча пока
подключаться быть вы ждать	ждать2 2ps подключаться 1ps	ждать2 poss 2ps 2ps подключаться 1ps
вы быть получать различный поручение	пример поручать различный	желание пример поручать различный
я быть учитывать возможность ваш город	1ps быть пример возможность poss 2ps город	1ps обучать2 потом потому.что город poss 2ps
также вы мочь находить я в соцсеть ВК фейсбук и написать я задавать вопрос я отвечать	кто мочь искать 1ps 1ps соцсеть ответ в-к фейсбук на	кто узнать2 мочь 2ps 1ps соцсеть ответ в-к фейсбук написать вопрос 1ps отвечать
следующий вога клуб глухой	следующий2 <dact> клуб глухой	следующий2 <dact> клуб глухой
я сам глухой общаться на жестовый язык мой родитель а также бабушка и дедушка тоже глухой и мы нормально общаться на жестовый язык	1ps сам2 глухой 1ps общаться на жестовом языке poss 1ps родиетли глу	1ps сам2 глухой poss 1ps говорить на жестовом языке poss 1ps родиетли глухой бабушка дедушка глухой 3ps pl говорить на жестовом языке нормально
если бы я не пойти работать переводчик я бы выбирать направление сурдопедагог и обучать бы ребенок с нарушение слух	если 1ps переводчик нет2 1ps работать2 переводчик 1ps выбирать направление <dact>	если 1ps поступать работать2 переводчик 1ps выбирать другой специальность направление <dact> преподавание обучать2 дети2 нарушение2 слух
да	д-а	д-а
укус лори мочь вызывать анафилактический шок и даже смерть говорить что лори подражать змей ядовитый	еда мочь вызывать афилический шок смерть мочь2 это ост	это 3ps кусать мочь 1ps <dact> 1ps смерть мочь2 это осторожно <dact> 3ps копировать змея похоже
о нет ты не мочь поехать на королевский бал в такой вид	2ps не мочь пойти королевский бал	нельзя уезжать королевский праздник бал такой 2ps
мы видеть что человек стоять взгляд испуганный	мы видеть человек стоять глаза какой clf clf.глаза clf.	1ps 1ps видеть человек стоять глаза какой clf clf.глаза clf.расшириться напуганный indx кашлять2 останавливаться
ехать нужно быть далеко но луиза не мочь пропустить такой событие	еда indx indx далеко3 н-о луиса не мочь пропустить	поехать далеко н-о пропускать3 не мочь
семья это труд друг о друг забота	семья это труд друг.друга забота	семья это труд делать друг.друга забота
например на помещение	пример комната	пример комната комната
на седьмой место муравьед	седьмой место муравьед	следующий3 <dact>
он вчера не купить мясо	о-н вчера мясо покупать не был	о-н 3ps вчера мясо покупать не был
он быть страшно но он стараться не показывать это	о-н был страх н-о стараться н-о 3ps pl показ	о-н был страх н-о стараться н-е показывать
жир сжигаться быстро и превращаться в энергия	<dact> быстрый изменять энергия	<dact> огонь быстрый изменение энергия
и как раз когда мы общаться в фейсбука там быть человек по имя аркадий белозовский	и <dact> раз когда фейсбук фейсбук был человекpl имя <dact> <dact>	<dact> <dact> связь когда фейсбук indx был беседовать indx имя <dact> <dact>
по-прежнему пусто	пустой не	пустой то.же.самое
у я быть принтер	1ps принтер2 1ps есть	1ps принтер2 иметь
а также углеводный пища потому что повышаться сахар и инсулин в кровь	еда множественный почему сахар2 выше.крыши выше.	плюс <dact> еда indx тоже почему сахар2 выше <dact> кровь тоже выше
для то чтобы вы быть заразный у вы не должно быть антитело	если 1ps заразный необходимость не иметь	если 1ps заразный 1ps необходимость внутри защита не иметь
мой жена тоже учиться в ЛВЦ она знать	poss 1ps жена лвц знать	poss 1ps жена лвц учить2 знать пример
в это институт учиться глухой и я там быть	институт глухой толпа есть indx был	институт глухой толпа есть indx это 1ps был indx
код из разный страна сразу узнавать друг друг радоваться начинать взаимодействовать друг с другой	кода знать poss 1ps русский пусть <dact> русский пусть clf clf.	глаз знать poss 1ps 1ps пример 1ps италия2 русский пусть <dact> 3ps одинаковый 3ps нейтр.имп радость clf clf.взаимодействовать общаться
следующий этап начинать копить на случай если оставаться без работа увольняться тогда что делать а резерв всегда быть	следующий все4 потом начинать копить если уволиться не.работать у	потом следующий все4 потом начинать копить вдруг 1ps не.работать уволиться что pl делать оставить есть
поэтому хром уменьшать тяга к сладкий	это хром уменьшать тяга сладкий	<dact> уменьшать2 3ps тянуть 1ps сладкий
хорошо	хорошо	хорошо
абсорбция другой соединение хром незначительный и составлять мало	абсорбция другой соединение хром не.знать2 составлять меньше	<dact> соединение успех мало меньше <nums> процент
за вертолет платить кто будет	вертолет деньги кто будет	вертолет деньги кто будет
почему	почему	почему
у мой брат быть чистый носок	poss 1ps брат чистота носки иметь	poss 1ps брат чистота носки иметь
изменяться мир ваш семья друг и коллега весь изменяться	измениться мир poss 2ps семья друг изменить будет	ваш семья мир изменить друг pl вместе работать все изменить будет
это агенство вообще мочь выделять переводчик на любой мероприятие вы же знать что вы по закон положенный переводчик поэтому не надо стесняться он просить	это <dact> мочь выделить переводить любой деятельность что соревнование indx подать	это indx это выделить перевод indx любой деятельность что соревнование indx подать.заявление и обратиться 2ps перевод пожалуйста обслуживать все терпеть должен закон indx есть все должен обслуживать перевод
получаться я продолжать работать и плюс обучать студент будущий переводчик	1ps получать2 1ps продолжать работать2 оставаться2 продолжать еще работать	1ps получать2 1ps продолжать работать2 оставаться2 продолжать еще работать2 плюс 1ps учить студент2 будущее переводчик
гордиться	гордый	гордый
вдруг ларсить замечать вдалеке свой папа	случай <dact> замечать смотреть2 вдалеке папа видеть	случай <dact> замечать clf clf.вдалеке indx папа видеть
следующий рыба фуга большой круглый рыба с пятно	изменить.направление рыба2 <dact> clf clf.рыба clf.круглая	изменить.направление рыба2 <dact> clf clf.рыба clf.круглая пятно pl clf clf.рыба clf.круглая
говорить голос и жест одновременно	говорить.на.жестовом.языке со.временем время со.времен	жестовый язык
привет	привет	привет
это специальный группа слышать ребенок у который родитель глухой	это специальность группа дети2 слышащий poss 3ps папа глухой	это специальность группа дети2 слышащий poss 3ps папа глухой
верно	правильно	правильно
во-первых в состав максимально эффективный комлпекс компонент экстракт гарциния и пиколинат хром	первый собирать есть тупик полезный общий <dact> и <dact>	первый собирать indx есть тупик полезный общий <dact> и <dact>
она входить вытирать рука о полотенце	девочка вытирать рука2 о полотенце	clf clf.человек clf.идет потирать.руки
вдруг он услышать в лес возмущать разговор зверь медведь заяц белок птица	слышать лес возмущаться разговаривать2 медведь возмущаться	слышать indx лес что разговаривать2 <dact> что indx был разговаривать2 медведь возмущаться заяц <dact> птица множество смешанный
молчать	молчать	молчать
что за надоедливый крыса что ты нужно	случай крыса2 вредный что желание	случай крыса2 вредный что желание
например масло коллаген и то что иметь глубокий увлажнение чтобы ухаживать за волос	пример масло ухаживать глубоко масло <dact> заботиться что был	пример масло ухаживать глубоко масло <dact> заботиться что был
я белый мишка с северный полюс	1ps белый медведь жизнь северный.полюс	1ps белый медведь жизнь северный.полюс
приходить посмотреть дом рядом с лес там жить мальчик который играть в лес	приходить2 смотреть рядом дом indx мальчик жизнь территория близко <dact> indx 	приходить2 смотреть2 рядом дом indx мальчик жизнь территория близко <dact> indx indx мальчик был indx дерево pl игра
нужно поставлять ряд задача написать устав	нужно поставлять ряд задача написать инициатива	нужно поставить pl список задание pl <dact> список список <dact> закон
чужой	чужой	чужой
у я в голова не укладываться вообще вот такой вот случай быть	1ps тупик ап попадать случай был	1ps 1ps тупик ап попадать случай был
сделать маленький десятисекундный репортаж и показывать	делать маленький4 секунда репортаж отправлять 3ps новости показывать	видео2 маленький4 <nums> секунда отправлять 3ps новости показывать
запираться	выключить	выключить
скоро вс починять	скоро чинить готовый	скоро чинить готовый будет
следующий лебедь очень красивый птица который жить пара и с который у мы связанный много представление о любовь	следующий3 лебедь clf clf.птица clf.машет clf 	следующий3 <dact> clf clf.птица clf.машет clf.крыльями clf clf.длинная clf.шея красивый clf clf.два clf.лебедя clf.склонили clf.друг clf.к clf.другу clf.головы всегда2 clf clf.два clf.лебедя clf.склонили clf.друг clf.к clf.другу clf.головы милый видеть всегда2 внутри любовь2 clf clf.два clf.лебедя clf.склонили clf.друг clf.к clf.другу clf.головы clf clf.птица clf.машет clf.крыльями
и я весь время поглядывать на ефросинья петровна	1ps всегда2 видеть сегодня2 бабушка <dact>	1ps всегда2 видеть взглянуть бабушка 3ps делать что
я показывать презентация	1ps показывать мультимедийная.презентация	1ps показывать мультимедийная.презентация indx
привет я звать елфимов светлана вот мо жестовый имя	аплодисменты 1ps имя <dact> <dact> poss 1ps жестовое.имя sn	аплодисменты 1ps имя <dact> <dact> poss 1ps жестовое.имя sn
сейчас жестовый язык популярный в мир слышать	сейчас3 россия язык популярный слышащий слышащий слыша	сейчас жест известный indx мир говорить
соглашаться	согласие	согласие
в Instagram быть группа мама в дело	indx есть группа мама дело	в instagram 1ps есть группа мама дело indx
даже к подросток нужный другой подход	даже подросток переезд средний2 другой работа будет	даже подросток переезд средний2 другой работа будет
например я работать в технологический музей видео гид и у они там очень хороший финансовый положение	пример 1ps технология музей <dact> indx финансирование2 лучше	пример 1ps делать технология музей и indx поручать видео <dact> indx финансирование2 лучше
перечить она не сметь	перечить	перечить
следующий жестовый пение театр глухой история или рассказ на РЖЯ	следующий2 жест пение театр глухой история жест рассказ <dact>	следующий2 жест пение театр глухой poss 3ps история жест рассказ <dact>
ребенок не осведомлять об это почему	дети2 не знать почему	3ps pl не знать почему
оказываться очень важный знать что у он быть друг	оказываться очень важный если знать у 3ps есть друг	оказываться очень важный если знать у 3ps есть друг
что нужно делать	что делать нужно	что делать нужно
привет	привет	привет
или написать свой мнение	или изменить.направление или2 poss 2ps мнение	или poss 2ps pl мнение написать
это подходить то кто хотеть но не мочь копить	это подходить кто желание н-о не.получаться копить подход	есть кто желание н-о не.получаться копить подходящий объяснять
смерть дорогой цена за красный роза восклицать соловей	смерть дорогой цена за красный цветок восклицать	смерть дорогой clf clf.вносить clf.деньги обмен2 красный цветок отвечать птица
отражение роза в серебряный зеркало отражение роза в недвижный вода вот каков быть роза расцветать на верхний побег куст	отражение роза clf clf.глаза clf.расшириться на недвижный	типа река отражение цветок нежный сиять так2 нежный светлый был цветок расти кусты clf clf.цветок clf.распукается clf.медленно
вопрос как вы относиться к инклюзивный образование когда глухой и слышать учиться вместе	вопрос инклюзия образование2 говорить глухой вместе	вопрос инклюзия образование2 говорить глухой вместе poss 2ps относиться как
и самый сложный это сам человек	сам2 сложный человекpl сам2 сложный	сам2 сложный это человек pl сам2 сложный
старый солдат идти в отпуск	старый солдат идти отпуск	старый солдат идти отпуск
следующий зима	следующий2 зима	следущий весна
нормально весь	нормально	нормально
восхищаться	восхищаться	восхищаться
у слышать билет стоты дорогой	у слышать билет стоты дорогой	у слышащий стоимость деньги больше
и что же теперь делать раз нет	и что делать делать	отсутствие pl что делать
ах какой счастие восклицать он	счастье какой счастье кричать	счастье какой счастье кричать
