Russian	Predicted	Truth
а когда дед мороз вернуться домой маленький дед мороз приходить к главный и сказать а я то вон в лес тоже подарок раздавать	дед.мороз clf clf.группа clf.группа clf.переместить дом	indx дед.мороз clf clf.группа clf.переместить домой clf clf.группа clf.переместить дед.мороз маленький встретить приходить обращение главный 1ps был лес подарок clf clf.перечислять
а мачеха лишать я весь радость	мама второй лишать 1ps радость	мама второй 3ps все радость давать 1ps ноль
зачем я хотеть изменять свой привычка тратить и начинать копить	зачем желание изменение привычка тратить все4 желание именение	зачем желание изменение все4 привычка тратить все4 желание именение привычка свой изменение тратить и копить думать
оказываться впервые это появляться в америка	америка первый прогресс	америка есть poss 3ps 3ps рассказ 1ps интересный америка первый прогресс
я вчера не стирать белье	1ps вчера стирать <dact>	1ps вчера стирать <dact> не был
она один за другой скидывать с себя туфля и прямо в один чулок подходить к дверь и у я от радость заколотиться сердце	дверь чулок бродить дверь 1ps думать скоро радость скоро скоро скоро рад	обувь2 убирать чулок бродить дверь 1ps думать радость 3ps скоро открывать.дверь сейчас скоро радость сердцебиение
тогда как	<dact>	<dact> дальше <dact>
заиграть первый луч солнце а друг уже у река	заигрывать солнце друг уже рядом река	утро солнце друг уже рядом река
я весь устраивать я быть интересно учиться и скоро я уже сам начало выполнять даже сложный заказ	1ps все делать 1ps интересный учиться и скоро готовый выполнять уже готов	1ps спокойный2 1ps был интересный учиться и время clf clf.время clf.идет 1ps уже сам2 получать даже сложный 3ps заказывать 1ps
мы отдыхать	мы отдых	мы отдых
нигде	нигде	<dact>
почему	почему	почему
он уметь кататься на лыжа	о-н мальчик 3ps знать лыжи	3ps знать лыжи
я не понимать то ли она плакать то ли смеяться	1ps не понимать н-о 3ps плакать плакать	1ps видеть не понимать 3ps плакать или смеяться
в общий немного эмоционально получаться	результат эмоция давать	результат эмоция давать
сегодня мы разбирать ещ один опасный ситуация связанный с дыхание	сегодня объяснять ещё <nums> опасность связать дышать	сегодня объяснять ещё <nums> опасность связать дышать
ты я не только разозлить но еще и расстраивать	2ps 2ps н-е только разозлить желание и расстраивать	2ps н-е только2 злость 1ps и плюс 1ps депрессия
хорошо радоваться тогда и дочь быстро поправляться	хорошо радость и дочь быстрый поправляться	пусть радоваться влиять 3ps дочь быстро здоровый будет
например в россия быть свой традиция	пример россия есть свой традиция	группа пример россия есть свой традиция
мочь быть и я вы помогать	мочь быть говорить 1ps помощь	мочь быть говорить 1ps помощь
сейчас мочь даже слышно в микрофон	сейчас мочь быть слышать микрофон	мочь быть немного слышать микрофон
кролик увидеть в цветок фея	кролик видеть цветок и <dact>	кролик что цветок и <dact>
он долго плыть и замечать вдали берег	долго clf clf.плыть замечать видеть indx clf clf.берег	долго clf clf.плыть clf.на clf.бочка замечать видеть indx clf clf.берег
жаль что я туда вс равно не попадать	жалость 1ps тоже indx попадать невозможный	жалость 1ps тоже indx попадать невозможный
не весь похоже понимать как это делать для себя а не для другой	себе для 1ps себе похоже все понимать не <dact>	себе делать похоже все не понимать как 1ps для 3ps делать
он отравляться	о-н отравляться	яд
много гриб собирать мальчик в лесной часто	много гриб собирать2 лес	много гриб собирать2 лес
без видео плохо но ладно я вы рассказывать сам история про англия	видео2 плохой 1ps 2ps 2ps рассказывать 2ps англия indx <dact>	видео2 indx плохой 1ps 2ps 1ps рассказывать 2ps англия indx <dact>
он замечательно п к печение любой форма например в вид зв здочка лочек	<dact> 3ps идеальный печь печенье вкусный форма звезда ель разныйpl	это 3ps идеальный печь печенье <dact> вкус любой это 3ps уметь форма звезда ель разный pl
это глагол прилагательное	<dact> <dact>	<dact> <dact>
к себя он приглашать я бояться но однажды он напрашиваться ко я на чай и увидеть мой условие жизнь предлагать пожениться и переезжать к он	1ps себя дом страшный приглашать 3ps н-о вдруг 1ps обратиться	1ps себя дом страшный 1ps приглашать 3ps н-о вдруг о-н 3ps обратиться 1ps imp чай пить о-н 3ps видеть 1ps poss 1ps условие2 все жизнь видеть imp жениться и переезд к 3ps
и вы обязательно нужно давать ответ рассказывать	и 2ps pl должен обратиться ответpl	2ps pl обязательно нужда ответ pl рассказ pl ответ pl
когда мы отжимать волос вода на они оставаться	н-о 1ps жать вода clf clf.вода clf.на clf 	н-о 1ps жать вода clf clf.вода clf.на clf.волосах что необходимость вода оставаться indx есть
хотеть продолжать тема созависимость пренебрежение себя	хотеть продолжать тема2 соотношение2 переживать нарушение2	привет
пищевой волокно связывать большой количество вода в кишечник превращать е в гель который затрудянуть усвоение углевод что сказываться на снижение уровень колебание сахар в кровь	волокна волокна связывать большой количество вода кишечник изменять это <dact>	еда волокна успех связь3 только2 больше жидкий вода кишечник успех изменять <dact> и успех <dact> indx конец и успех 3ps давать 1ps уменьшать2 уровень колебание кровь
в строчка выбирать вариант или	строчка связать <nums> ответ	строчка связать <nums> 2ps выбрать <nums> ответ
когда появляться проблема нужно быстро придумывать как они решать	проблема2 появляться быстрый возникать <dact> решать	проблема2 появляться быстро решать что придумывать быстро решать
потом я становиться искать какой-нибудь конкурс и наш л один который проводить среди слышать проводиться он два или три день в общий сложность	1ps искать 1ps все включено это 3ps pl говорить соревнование <nums> день <nums> день	1ps искать соревнование indx говорить соревнование 1ps все включено это все включено говорить соревнование <nums> день <nums> день <nums> факт2 indx дактилировать
у я быть я крутой у я быть связь	1ps куда крутой 1ps связь	1ps мочь круто 1ps связь2 есть
я тоже хотеть ходить на бал	1ps тоже желание ходить бал	1ps тоже желание посещать pl clf clf.пышная clf.юбка танцевать <dact>
мы знать это животное по мультфильм оно выглядеть так мило что мы и не думать о то что оно опасный а оно опасный	знать это животное2 мультфильм2 интересный н-о 3ps опасный	знать вы животное2 мультфильм2 интересный clf clf.милая clf.пушистая clf.мордочка милый 3ps думать неопасный н-о 3ps опасный есть
наш организация существовать с го год	poss 1ps организация существовать <nums> год	это poss 1ps pl организация существовать уже <nums> год
видеть по-разному	видеть разный	видеть разный
второй шаг	второй шаг	второй шаг <dact>
что вообще мочь сделать мы счастливый легко и быстро	как вообще что мочь делать мы мы очень легко2 быстро2	как вообще что влиять на 1ps мочь мы делать счастье очень легко2 быстро2
подруга рассказывать о свой проблема я тоже поделиться свой	подруга 3ps рассказывать 2ps собственность проблема2 3ps тоже 1ps рассказывать 3ps собственный	друг 3ps рассказывать 1ps собственность проблема2 3ps рассказывать 1ps 1ps тоже 1ps рассказывать 3ps делить
хорошо	хорошо	хорошо
немного зима посмотреть и лето быть	зима смотреть лето быть	немного зима смотреть2 лето есть
хитрый	хитрый	хитрый
номер три это животное который называться древолаз	<dact> indx животное indx назвать <dact>	еще есть животное2 назвать <dact>
а человек видеть мир по-разному	а человек видеть различный	а человек pl видеть различный
в год в павловск построить ленинградский восстановительный центр	<nums> год павловск <dact> стройка clf ленинград восстанавливать центр	смотреть <nums> год <nums> год павловск <dact> indx стройка clf ленинград восстанавливать центр
мой бабушка не любить гулять ночь	poss бабушка2 не.любить гулять ночь	poss 1ps бабушка2 не.любить гулять ночь
нет так нет ну и ладно	нет2 так нет2 н-у ладно	нет2 так нет2 н-у
такой человек называть элита	новый <dact> человекpl назвать <dact>	новый все человек pl назвать <dact>
сейчас я видеть весь больше и больше небольшой команда который пытаться что-то делать как-то развиваться	сейчас всё 1ps видеть больше маленький3 команда и-п сам2	сейчас всё 1ps видеть больше маленький3 команда и-п сам2 достигать так развивать
ребенок весь понимать	ребенок понимать2.наизусть	все дети понимать2.наизусть
няня весь собирать и выбрасывать а мальчик давать новый белый с блестящий мех	няня все собирать и выбрасывать новый мальчик новый белый с	няня2 ладно собирать2 выбросить2 мальчик давать новый белый мех блестящий
для кто-то нужно утяжеление для кто-то чтобы быть разглаживание	вол кто тяжелый тяжелый для2 кто кто clf clf	<dact> кто тяжелый clf clf.волосы clf.тяжелые <dact> кто clf clf.волосы clf.гладкие clf clf.волосы clf.лежат clf clf.волосы что был
начальник говорить мы же готовый он взять у мы быть такой рабочий место но по факт человек с инвалидность никогда не пойд т на это место	начальник говорить готовый должен принять у 1ps место но п-о факт человек	начальник говорить мы готовый принять такой место у 1ps есть приглашать но п-о факт2 никогда это место инвалид вступить.не
ты должный позвонить мама а то она будет беспокоиться	2ps должен мама 3ps звонить.по.телефону 3ps волнение будет	2ps должен мама 1ps звонить.по.телефону 3ps 3ps волнение будет
я сидеть в свой комната учиться не пойти но жить на что-то надо быть	1ps сидеть комната учиться не.нужно все деньги жизнь нужда	всегда2 сидеть комната учиться нет нужно деньги жизнь
я обращаться и в другой место например в вога и там я тоже оформлять письмо поддержка такой образ уже они у я быть несколько	1ps обращаться 1ps другой место пример 1ps вога 1ps тоже 1ps письмо поддерж	другой pl посещаемость надеяться indx и 1ps тоже <dact> 1ps обращаться <dact> тоже indx 3ps поддерживать 1ps печать 1ps повезло clf clf.складывать clf.письма clf.вместе уже
я не нравиться яркий одежда	1ps яркий светлый одежда2 не нравиться	1ps яркий светлый одежда2 не нравиться
глупый	глупый	дурак
сейчас для наш человек это возможность действительно заниматься любимый дело	сейчас для наш человек это возможность действительно плюс заниматься	сейчас мы человек pl это возможность действительно работа любить работа
если педагог видеть что он разговаривать хорошо и весь понимать то он без проблема идти в отделение и учиться год	если ребенок видеть 3ps разговаривать2 хорошо понимать <nums> год <nums> 	если смотреть ребенок разговаривать2 хорошо понимать все <nums> подразделение год <nums> учить2 не
потом домой приходить и мама просить еще урок проводить	домой проходить и мама просить еще урок проводить	домой мама еще считать3 уроки
например двое мой ребенок говорить на жестовый язык	дополнение пример poss 1ps дети говорить на жестовом языке	дополнение пример poss 1ps дети <nums> глухой не говорить на жестовом языке
почему у мы в россия это не популярный	1ps россия популярный нет2 почему	1ps россия популярный нет2 почему
журналист просто бер т этот новость и публиковать на сайт с красивый картинка	1ps берть 1ps отправлять 3ps отправлять 1ps новости красивый картина	1ps взять публиковать 1ps отправлять 3ps <dact> красивый картина
я жить в краснодарский край	1ps жить кавказ место краснодар	1ps жить кавказ место краснодар территория
нужно изучать основа чтобы иметь общий пердставление о они чтобы экскурсовод мочь об этоя рассказывать	основной2 нужда изучать что общий есть общий <dact> 3ps pl рассказ indx 	основной2 нужда изучать что общий получать воображение 3ps pl рассказ indx будет экскурсия человек экскурсия человек
я вы совсем не знать но я кажется готовый смотреть в ваш глаз вечность	1ps 2ps не знать н-о 1ps казаться poss 2ps глазpl готовый зр	дорогой девочка знакомый не 1ps 2ps совсем не знать н-о 1ps казаться 1ps poss 2ps глаз pl готовый зрительный.контакт вечность
а этот мужчина быть сантехник который чинить прорыв канализация и который обливать дерьмо тома давать он халат муж и разрешать подождать пока он привозить чистый вещь	а мужчина2 <dact> это сантехник и <dact> сантехник <dact> исправлять 3ps ту	а мужчина2 это кто сантехник <dact> сантехник 1ps исправлять 3ps туалет канализация clf clf.облило clf.из clf.канализации грязь туалет <dact> для халат муж и зафиксировать пока приносить чистый poss 3ps одежда3
скоро быть праздник	скоро будет праздник	скоро будет праздник
пока спасатель ехать мальчик сидеть рядом и следить	пока спасатель ехать мальчик рядом следить	пока спасать clf clf.человек clf.прийти 3ps мальчик рядом следить н-о жалость
весь целый весь пока	все пока	воздушный.поцелуй аплодисменты
усердный	усердно.трудиться	усердно.трудиться
открываться дверь	дверь открытый	открывать.дверь
он мочь бить себя по грудь или по стол пытаться показывать что он плохо и нужный помощь	бить себя лицо почему пытаться <dact> стол пытаться показывать 3ps	получаться 3ps clf clf.хлопать clf.по clf.грудь clf clf.хлопать clf.по clf.стол тоже показывать все 3ps помогать 1ps тоже плохой
представлять что инициативный группа хотеть разрабатывать проект который помогать избавляться от этот проблема и не давать она развиваться	ладно группа группа желание разрабатывать проект проблема2 убирать живот развити	ладно группа гап делать indx проект проблема2 убирать живот развитие нет проблема убирать
жертва это когда вс что ты делать ты делать в ущерб себя	жертва это когда2 2ps делать отдавать.себя себе делать	<dact> называть <dact> что делать 1ps делать отдавать.себя себе думать нет
медвежонок плыть на льдина	медведь маленький3 clf clf.плыть clf.толстый	медведь маленький3 clf clf.круглый clf.предмет clf.плыть clf clf.толстый clf.лед <dact> clf clf.запрыгнуть clf clf.на clf.четырех clf.лапах плыть
я этот никто не учить	1ps никто учить2 не был	1ps научить 1ps никто
например дма она заставлять она делать самый тяжелый работая	пример <dact> 3ps тяжелый работая	например дом самый сложный тяжелый труд clf clf.сесть clf.на clf.шею
на улица быть тепло и мальчик хотеть пойти гулять однако начинаться дождь	территория улица есть тепло и мальчик желание гулять дождь	indx смотреть улица теплота мальчик желание выходить гулять начать дождь
смотреть на вы	смотреть 2ps	смотреть 2ps
что там	что indx	что indx
он облизываться	вкус облизывать	вкус облизывать
идентичность я глухой и ты глухой	следующий2 1ps одинаковый 2ps слышащий 2ps глухой кровь2 2ps	следующий2 яг 1ps одинаковый 2ps 1ps глухой кровь2 2ps глухой 1ps одинаковый 2ps
если весь быть копить не нужно откладывать на всякий случай	копить если все есть не.нужно все есть случайpl	копить 1ps копить не.нужно все есть это запас вклад
сура в адаптис плохой перевод в субтитр такой замечание	<dact> indx субтитры плохой замечание2	<dact> <dact> плохой субтитры перевод плохой замечание2
у я нет сила	1ps сила дефицит	1ps сила дефицит
этот верхний пункт сокращать но затратный ресурс быть всегда	indx это clf clf.деньги clf.уменьшаться <nums> расходы clf clf 	это clf clf.деньги clf.уменьшаться <nums> расходы <dact> всегда постоянный тратить pl
здесь жить дружно поколение старший бабушка и дедушка средний мама и папа и младший ребенок катя и антон	indx дружба жить вместе <nums> поколение старший бабушка2 дедушка второй	indx дружба жить вместе <nums> поколение старший бабушка2 дедушка второй мама папа третий младший дети <dact> <dact>
я должный завершать еще пара важный дело пока	желание завершать еще <nums> важный дело пока	1ps должен конец <nums> важный дело пока
понятно	понятый	понятый
сегодня мы продолжать разбирать программа slim	сегодня2 продолжать <nums> д <dact>	сегодня2 продолжать <nums> исследовать <nums> д <dact>
но сначала давать разбираться как усваиваться пища	н-о начинать исследовать <dact> <dact>	н-о исследовать <dact> 1ps еда воспринимать <dact>
рассказывать еще	рассказывать еще	жестовый язык кто еще был рассказывать
терять	потерять2	потерять2
он приносить одеяло из дом и накрывать собака обращаться к взрослый за помощь	одеяло дом clf clf.взять clf.принести одеяло обращаться	одеяло дом clf clf.взять clf.принести одеяло обращаться взрослый помогать 3ps 3ps
даже мэр город приезжать чтобы успокаивать мальчик	даже <dact> город приезжать что 3ps успокаивать мальчик	и даже <dact> город поехать гость 3ps 3ps успокоить 3ps 3ps pl
например компьютер ноутбук проектор стул стол и всякий вещь	пример компьютер компьютер <dact> стул стол <nums> всякий вещь	пример компьютер ноутбук проектор мелочь стул pl стол был
здравствовать	здравствуйте	здравствуйте
сейчас я объяснять как и что	1ps сегодня2 1ps рассказывать 2ps что <dact> это	1ps сегодня2 1ps рассказывать 2ps что <dact> это
она просыпаться и она быть очень тесно	проснуться и тесный был тесный	проснуться и тесный был нормальный тесный
идти дождь и мы решать оставаться дом и посмотреть фильм	дождь и 1ps решать оставаться дом смотреть2 фильм3	дождь 1ps думать решать оставаться дом и смотреть2 фильм2
весь что она удаваться находить это работа дворник в соседний двор но больший она и не нужно быть главное что хватать платить за квартира а на ехать она надо быть совсем немного потому что она почти ничто не есть и похудеть до неузнаваемость	все территория территория территория территория н-о дворник сосед indx 	и все что мочь2 успех только2 работать дворник сосед indx территория н-о дворник достаточно квартира платить есть деньги еда должен нет много <dact> чуть-чуть еда нет ничего2 худеть видеть лицо узнать нет
кто она резать	кто она резать	3ps кто 3ps разрезать 1ps
что вообще представлять себя этот организация и зачем она нужный	это организация что почему и-з для что	это организация здесь для что
видимо становиться больше сажать культура и из-за большой количество урожай он становиться собираться поздно	больше clf clf.сажать clf.в clf.землю урожай собира	больше clf clf.сажать clf.в clf.землю урожай собирать2 выше начинать позже собирать2
в это место очень много турист благодаря то что здесь много исторический здание	indx место indx много посетить <dact> это здание очень большой	это место много 3ps приезжать путешествие <dact> почему это место2 много исторический clf музей разный
семья это много домашний работа	семья это много домашний работа	семья это много дом работать
но я никогда не встречать	1ps встречаться никогда	1ps встречаться никогда
потому что нет общение нет любовь и понимание и он быть просто как собачка это очень страшно а у тот трое быть семья любовь общение и вот это реально до мурашки	любовь ноль2 общение ноль2 обнимать ноль2 игнор	общение ноль2 любовь ноль2 обнимать ноль2 игнорировать2 одинаковый собака2 clf clf.собака clf.прислушивается папа иса indx боль 3ps pl общение это 3ps pl 3ps pl спасибо общение делить думать сохранение понимать спасибо папа папа 3ps clf clf.мурашки clf.по clf.коже
в ноябрь будет год как я официально работать переводчик	ноябрь официальный 1ps работать2 переводчик уже <nums> год	ноябрь официальный 1ps работать2 переводчик уже <nums> год
я ждать твой звонок но ты я не позвонить	1ps ждать2 poss 2ps pl звонить.по.телефону 1ps 2ps тоже	1ps ждать2 когда2 3ps звонить.по.телефону 1ps 2ps тоже 3ps звонить.по.телефону 1ps нет2
рядом с печень желчный пузырь который удерживать желчь до необходимый момент	печень рядом <dact> clf clf.пузырь clf.пузырь clf	печень рядом <dact> <dact> clf clf.желчный clf.пузырь indx <dact> действие оставить нужно clf clf.желчь clf.убрать
лев лишь рассмеяться	смеяться3 лев смеяться3	смеяться3 лев смеяться смеяться3
интересно	интересный	интересный
я быстро получать обещать жилье но это быть маленький комнатка в коммуналка где сосед ввергать в шок при первый же встреча	1ps быстрый получать дом это был маленький3 комната соседpl квартира	1ps быстрый получать дом это был маленький3 комната сосед pl квартира сосед pl все сумасшедший3 1ps взглянуть
осаня начинаться в конец октябрь в ноябрь или декабрь	всегда осень2 начинать октябрь последний3 ноябрь декабрь всегда	всегда осень2 начинать октябрь последний3 ноябрь декабрь всегда изменить.направление
интересно так	интересный	интересный так
второй вариант частично да частично нет	второй половина да половина <dact> слабый	второй половина да половина <dact> слабый
ничто из еда нет	еда ничего3	еда indx pl ноль
я любить голубой цвет а мой сестра ненавидеть он	1ps любить голубой цвет poss 1ps сестра ненавидеть2	poss 1ps любить голубой цвет голубой poss 1ps сестра ненавидеть2
переводчик слушать речь и переводить на жестовый язык	переводчик слушать 3ps речь 1ps 3ps рассказывать.на.ржя рассказывать	переводчик слушать 3ps речь 1ps 2ps 1ps рассказывать.на.ржя рассказывать переводить рассказывать переводить
если бы у мы в школа россия знать что глухой ребенок из семья глухой свободно говорить на жестовый язык и он учить бы переход с жестовый язык на русский то в школа бы привыкать обучать на жестовый и у ребенок быть бы грамотный русский язык	если б-ы poss 1ps россия площадь б-ы школа вокруг знать	что если б-ы poss 1ps россия площадь б-ы школа вокруг знать ребенок глухой семья глухой говорить на жестовом языке <dact> переезд школа б-ы привычка обучать2 жестовый язык поменять грамотность poss 3ps русский язык
веселый	веселый	веселый
первый вариант принимать такой как быть	первый принимать такой2 как есть	первый принимать такой2 как есть
а если с реб нком в семья общаться при помощь устный речь а жестовый язык считать ненужный это не совсем CODA	а если есть кто дети мама семья глухой родиться слыша	а если есть кто дети2 мама семья глухой ребёнок дети2 родиться слышащий говорить2 жестовый.язык не.нужно говорить2 беседовать poss 1ps кода indx нет indx
этот чувство доброта и любовь появляться в человек сам по себя	этот чувство доброта и любовь появляться человек сам2 по себя	чувство добрый любовь появляться человек автоматический согласие
когда я забеременеть то так же работать до последний а потом еще и на дом брать подработка	когда2 1ps беременность 1ps работать до <dact> приближаться плюс дом получатьpl	когда2 1ps беременность 1ps работать до <dact> приближаться плюс дом получать pl работать
как становиться эмоциональный энергичный воодушевлять свой жизнь	как становиться эмоция энергия воодушевление свой жизнь как	как стоять эмоция энергия воодушевление свой жизнь как
год он лечиться и выздоравливать	год <nums> о-н лечение выздороветь и выздороветь	год <nums> лечение заболеть здоровый
ты знать кто я	2ps знать кто 1ps	2ps знать кто 1ps
также природа выделять жир роль запасной энергоноситель т е поступать жир пойти на образование энергия но только в случай крайний энергодефицит	успех и плюс природа 3ps давать 1ps электричество <dact> <dact> indx отправлять	успех и плюс природа 3ps давать 1ps электричество <dact> <dact> indx 3ps отправлять 1ps н-а основывать электричество только2 если 1ps электричество недоставать
заболевать	заболеть	заболеть
дедушка помогать антон они вместе записывать весь история семья	дедушка помогать <dact> они вместе записывать все история семья	дедушка 1ps помогать 3ps <dact> вместе писать записать все история семья
на это мероприятие приглашаться весь дама и королева который хотеть повеселиться и отдыхать вместе со я принц это королевство сын король и наследник престол	это мероприятие праздник приглашать все девочка кто мечтать желание веселиться	это мероприятие праздник приглашать все девочка кто мечтать желание веселиться отдых 1ps вместе 3ps 1ps принц руководить это территория сын король наследство дать 1ps престол
дотащить он мешок в лес и раздавать подарок весь животное они очень обрадоваться	clf clf.принести clf.принести лес и подарокpl каждый	clf clf.принести indx лес и подарок pl каждый животное2 подарок все возбуждение
на концерт	зал	зал
он лежать мертвый в высокий трава и в сердце у он быть острый шип	птица2 лежать птица2 высокий птица2 сердце	о-н смерть трава clf clf.птица clf.упала clf.в clf.траву сердце птица2 indx был острый шип
женщина любить носить шуба они тоже защищать от ветер	женщинаpl любить носить шуба2 тоже ветер защита	женщина pl любить носить шуба2 тоже включать ветер защита
снег растаивать потому что выглядывать солнце	снег таять почему солнце	снег таять почему солнце
этот конкурс следующий конкурс увидеть принимать участие	этот соревнование следующий соревнование заметить.принимать участие	indx соревнование следующий соревнование заметить3 это 2ps стараться принимать участие
если вы решать участвовать в конкурс быть бы хорошо если бы у вы уже быть готовый проект потому что так легко будет о н м рассказывать доказывать он нужность	если 2ps pl участвовать 2ps будет быть готовый проект 2ps уже у 2ps	что любой соревнование принимающий участие желание б-ы проект все готовый легкий принимающий участие проект есть легкий принимающий участие 1ps рассказывать 2ps доказывать легкий
этот организация только для слышать ребенок CODA	это организация только2 слышащий дети2 кода кода	indx это организация только <dact> дети2 слышащий кода
но помнить что масло бывать опасный	н-о помнить что если масло бывает это опасный	н-о помнить что если масло бывает это опасный
грубый	грубый	грубый
раз ты просить я подождать	2ps 2ps просить 1ps ждать	2ps просить 1ps ждать
наш сми за вс в то число и за размещение публикация хотеть получать деньги	poss 1ps pl <dact> желание деньги размещение публикация желание получать	у 1ps pl <dact> желание деньги нужда публиковать новости так ведомый деньги
самостоятельно выбирать ответ пожалуйста	сам2 нажать отвечать пожалуйста	сам2 нажать отвечать пожалуйста
благодаря сплоченность весь команда они выигрывать	благодаря все команда 3ps pl хорошо	спасибо команда дружба 3ps pl найти
и слышать и глухой приходить и организовывать свой группа	приходитьpl слышащий толпа группаpl свой группа глухой	приходить pl слышащий толпа группа pl свой группа глухой
опытный	опытный	опытный
вс весь пока	все пока	все пока
ждать ваш звонок	ждать2 poss 2ps pl 2ps звонить 1ps	ждать2 ваш звонить.по.видеосвязи
крепкий	крепкий2	твердый
например здесь в россия мы открывать свой организация код но мы выбирать русскоязычный название слышать ребенок в семья глухой	пример 1ps здесь россия 1ps создавать2 кода а факт2 называть	пример 1ps здесь россия 1ps создавать2 кода а факт2 clf clf.появиться называть <dact> poss 3ps россия 1ps называть слышащий слышать дети2 семья глухой
еще бывать по-другому при полный блокада дыхательный путь ситуация тяжелый человек не мочь говорить кашлять и дышать т е полный тишина	еще быть другой когда2 о-т человек тяжелый ды	еще по-другому если полный indx останавливаться это тяжелый человек говорить не.мочь.сделать кашлять2 не мочь дышать не мочь 1ps молчать тихий
я быть сильно тосковать когда ты не становиться	отвечать 1ps будет очень сильный скучать без 2ps будет	отвечать 1ps будет очень сильный скучать без вы
ставить лайк и деваться этот видео если оно ты понравиться	ставить лайк делиться этот видео2 если 2ps нравиться	ставить.лайк и делиться это видео если 2ps нравиться
я повезти что проект быть выполнять давно	1ps давно давно проект выполнять	1ps повезло и проект давно был выполнять
кто не видеть это видео в описание будет ссылка на это он и ссылка на плейлист урок остеопатия там вы находить очень много полезный и интересный	кто видеть не видео2 о писать <dact> будет ссылка написать	кто когда2 видеть не видео2 будет indx копировать копировать о писать <dact> это урок <dact> мочь видеть и мочь успех кто интересный множественный очень полезный
нечего дом сидеть с малыш я сам справляться а ты быть прибегать и кормить он	бесплатный прохлада хватит 1ps сам2 ребенок 2ps приходить и кормить	бесплатный прохлада хватит 1ps сам2 ребенок 2ps будет приходить и кормить ребенок
специальность быть весь тот же программирование	специальность специальность программа все компьютер	п-о специальность то.же.самое направление компьютер
только сам без мой подсказка	н-о сам2 без poss 1ps подсказывать	н-о сам2 без poss 1ps подсказывать
этот процесс нарастать и человек у который быть килограмм лишний начинать набирать вес ещ быстро словно из воздух	это indx начинать clf clf.время clf.летит человек это множественный	успех у 3ps человек это есть лишний вес пример <nums> к-г лишний успех еще больше pl похоже ничего3 похоже больше pl успех
в нет год быть школа грантовый проектирование да	<nums> время ничего3 школа <dact> проект проект давать	<nums> ш школа г проект п проект да indx
у мой брат нет жена	poss 1ps брат жена нет2	poss 1ps брат жена нет2
начинать учить жестовый язык	начинать учить3 жестовый.язык	начать учить3 жестовый язык
и я непонятно почему вдруг опять чихнуть изо весь сила с какой-то даже подвывание чихнуть вот так апчхи уу	1ps новый 1ps зачем не понимать 1ps <dact> <dact>	1ps новый 1ps зачем не понимать 1ps <dact> <dact>
зима здесь очень холодно особенно в январь начало февраль	зима очень заморозить январь начинать февраль	зима очень заморозить январь февраль срок.между
но получаться так что я глухой я же не смочь быть педагог	успех вот 1ps глухой преподавание не.мочь 1ps преподавание	успех вот 1ps глухой преподавание не.мочь 1ps преподавание
и улучшать углеводный обмен а именно чувствительность рецептор клетка инсулин они снижать аппетит и тяга к сладкий поэтому вечерний капсула рекомендоваться принимать за минута до еда	еще лучше2 <dact> обмен еда чувство организм клетка2 <dact>	еще лучше2 <dact> clf clf.организм clf.процесс и чувство <dact> клетка2 <dact> indx ниже еда еще сладкий не.хотеть2 вечер капсула2 советовать з-а <nums> минута до будет еда
мы с вы рано не встречаться	мы.вдвоем раньше встречаться был не был	мы.вдвоем раньше встречаться был не был
так сейчас	сейчас	сейчас
там уже быть показываться другой новость	и indx уже clf clf.новость clf.выключить другой	другой новость clf clf.новость clf.подниматься уже
и тогда ваш жизнь обязателньо будет счастливый	и будет ваш жизнь нужно счастье	даже poss 2ps жизнь будет обязательный счастье
я не нравиться этот футболка то быть я не быть она покупать	1ps футболка покупать не был	1ps футболка не нравиться тоже покупать не будет
наказывать	наказание	наказание
следующий одинаковый мировоззрение и восприятие мир	следующий2 мировоззрение восприятие думать мнениеpl о мир2 у	следующий2 мировоззрение восприятие думать мнение pl о мир2 у.всех.одинаково
быть момент когда я нужно быть находить музей и я обращаться к наставник а они находить нужный человек и обменять мы номер	1ps обратиться пожалуйста 1ps обратиться пожалуйста информировать 3ps обратиться пожалуйста информировать	1ps недоставать 1ps обратиться пожалуйста искать <dact> был 1ps искать нужно это 1ps обратиться пожалуйста <dact> успех 3ps хороший 3ps искать успех и обмен poss 3ps clf clf.сводить clf.людей
а кролик сидеть в мешок переживать вспоминать хороший время как играть с мальчик и общаться с лощадь	indx кролик переживать помнить был хорошо время мальчик беседовать игра indx лоша	indx <dact> clf clf.куча кролик переживать помнить был хорошо время мальчик беседовать игра indx лошадь был общаться
какой причина	причина какой	причина какой
привет я звать мир	приветствовать 1ps имя <dact>	приветствовать 1ps имя <dact>
этот механизм будет работать только если мы взять грамм белок грамм жир из жировой запас и грамм глюкоза из гликоген	это indx <dact> indx <dact> и-з <dact> <dact> и-з <dact> <dact> и	успех <dact> <nums> грамм indx <dact> <dact> и-з <dact> выбирать
и чем	<dact>	<dact>
у я нет никакой одежда	1ps одежда2 нет2	1ps одежда2 нет3 нет2
здесь пособие не выдавать	пособие деньги не	пособие деньги 1ps помогать 3ps давать 1ps нет2
твердый	твердый	твердый2
мочь быть у вы другой причина я не знать у весь по свой	мочь быть у 2ps pl другой причина 1ps не.знать свойpl	мочь быть у 2ps pl другой причина indx не.знать2 свой pl
тихий	тихий	тихий
нога муж лечить несколько месяц а потом он вернуться домой к нормальный жизнь	нога муж исправлять 3ps несколько месяц а проходить о-н возвращ	indx 1ps исправлять 3ps некоторый месяц а проходить о-н возвращаться домой к обычный жизнь
он постучаться в последний дом и прокричать впускать отдыхать дорожный человек	3ps clf clf.приостанавливаться дом последний3 прокричать впускать	indx последний смотреть стучать2 кричать выпуск дорога2 человек отдых
мы приезжать сюда с цель увидеть храм	1ps приезжать зачем что видеть церковь <dact> дворец	1ps приезжать зачем что видеть церковь <dact> дворец
если вы сомневаться нужно или не нужно то хорошо добавлять бальзам ничто страшный не будет	если вы сомневаться необходимость не.нужно улучшать <dact> добавлять	если вы сомневаться необходимость не.нужно улучшать <dact> добавлять можно страх не иметь
я можно находить в Instagram во вконтакте	можно находить 1ps instagram indx можно вконтакте можно	можно находить 1ps instagram indx можно вконтакте 1ps
мокрый	мокрый	мокрый
мы брать разный проект к пример взять один проект и заплатить человек взять второй и третий заплатить тоже	1ps pl проект делать пример взять проект и 3ps платить2 человекpl третий	проект другой получать pl indx пример indx проект indx зарплата 1ps 3ps человек indx зарплата 1ps 3ps indx зарплата 1ps 3ps
весь что у вы в жизнь происходить будет меняться	все у 2ps pl будет жизнь изменить будет	все что у 2ps pl случай pl жизнь будет изменить
в год весь немного поутихнуть и решать проводить II съезд глухой	<nums> год чуть-чуть поутихать решать н-о indx <dact>	<nums> год чуть-чуть успокоить и <nums> год желание проводить второй форум второй форум желание проводить clf clf.люди clf.собираются clf.в clf.одном clf.месте н-о indx <dact> indx
мой друг захотеть перечитывать сказка владимир григорьевич сутеев	poss 1ps друг желание читать дизайн <dact> <dact> <dact>	poss 1ps друг желание читать дизайн <dact> <dact> <dact>
я должный уметь побеждать в война	1ps должен качественный стратегия что война	1ps обязанность качественный стратегия что война победа
там рассматривать мой проект спрашивать чем помогать и помогать я стараться участвовать в любой соревнование в новосибирск и другой город буквально в любой	indx рассматривать проект 1ps спрашивать 1ps помогать 2ps стараться любой соревн	clf clf.рассматривать clf.проект что нужно 1ps просить перечислять 1ps давать 2ps стараться любой соревнование что здесь новосибирск традиция город некоторый тоже традиция это indx соревнование успех принимающий участие
если месяц назад то на самоизоляция а если месяц или тогда как	<nums> месяц раньше <nums> месяц т-о самоизоляция если месяц 3 <dact>	<nums> месяц раньше <nums> месяц т-о самоизоляция если месяц <nums> месяц 3 <dact>
когда льдина уже почти растаивать он увидеть в вода деревянный бочка	когда2 <dact> таять таять медведь замечать вода деревянный бочка	когда быстрый таять clf clf.льдина таять медведь замечать вода indx деревянный бочка clf clf.бочка clf.плывет
например нужно или нет учить характер общение с ребенок	например характер общаться с ребенок необходимость не.нужно	например характер общаться с ребенок необходимость не.нужно
поэтому должный быть отдельный факультет для тот кто хотеть продолжать качественно учиться с переводчик	поэтому должен быть отдельный <dact> 3ps кто желание продолжать качественный	поэтому должен быть отдельный <dact> 3ps кто желание продолжать качественный clf clf.человек clf.приходить переводчик преподавание переводчик indx
семья это счастие любовь и удача	семья это счастье любовь и удача	семья это счастье любить счастье удача
видео мы отправлять несколько человек давать он весь посмотреть	видео отправлять.сообщениеpl смотреть некоторый человекpl давать 3ps pl	видео отправлять.сообщение pl все просить смотреть смотреть2
когда в школа глухой работать переводчик то они согласный приходить	школа глухой работать есть переводчик гап	школа глухой работать есть переводчик 1ps приходить гап
наш настроение легко портиться из-за политика из-за другой ситуация отношение	poss 1ps настроение легко грустить влиять 1ps политика другой случайpl	мы очень легко грустить влиять 1ps страдать политика другой случай pl
на сегодняшний форум проблема со связь	сегодня2 сегодня2 проблема2 со.временем	здесь сегодня <dact> проблема2 интернет связь
не столько я себя плохо чувствовать сколько хотеть оставаться дом и никто не видеть	1ps н-е только2 чувствовать плохо.себя.чувствовать	1ps н-е только2 чувствовать плохо.себя.чувствовать плюс 1ps не хотеть никто видеть
если у вы появляться ещ вопрос писать мы в комментарий под видео	если у 2ps появляться вопрос ещё <nums> комментарии	или случай ещё есть вопрос писать комментарии
а за остальной деньги куда пойти	деньги куда	а indx нужно <nums> успех <nums> еще деньги clf clf.много clf clf.деньги куда
понимать нужно делать шаг для это развитие а не то как вы требовать давать и далеко сидеть сложа рука	шагpl это развитие понимать необходимость <dact> 2ps pl требовать <dact>	шаг pl <dact> необходимость <dact> это развитие понимать 2ps желание требовать <dact>
отставать	отправить	отстать
ваш обычный еда не мочь так как я виноград гилберт	обычный еда н-е не мочь	еда обычный простой все4 не мочь это 1ps виноград <dact>
она посмотреть вверх и увидеть красивый голубой небо и облако	clf clf.поднять звезда clf clf.много clf.на clf 	clf clf.посмотреть clf.вверх красивый <dact> небо голубой и <dact> clf clf.облако clf.pl
из москва	москва	и-з москва
умный	умный	умный
если она не давать то она начинать гавкать	если давать 3ps 3ps гавканье	если давать 3ps 1ps 3ps гавканье
и тот быть тоже быть ехать грязный рука	еда грязный	еда грязный
белый и зеленый чай зеленый кофе содержать природный кофеин который повышать влияние адреналин на жировой ткань в результат гореть наш жир	белый зеленый <dact> зеленый <dact> зеленый <dact> составлять природа давать энергия	белый2 зеленый <dact> зеленый <dact> составлять природа давать <dact> это давать энергия увеличение <dact> <dact> ткань получаться poss 2ps <dact> огонь
можно еще кондиционер в вид пена он легкий сглаживать волос и придавать легкий увлажнение	можно <dact> пена легко clf clf.сглаживать clf clf.волосы	можно <dact> <dact> пена легко clf clf.сглаживать clf clf.волосы легко увлажнение
опыт помогать я чувствовать себя уверенный в себя	опыт 1ps помогать 1ps уверенный себя чувствовать	indx 1ps чувствовать себя уверенный
ну да давать премия вс правильно	премия 3ps давать 1ps	премия 3ps давать 1ps
терпимость это то что сегодня так не хватать	терпимость это сегодня нужно	терпимость это сегодня нужно pl
май самый т плый весенний месяц	<dact> <nums> весенний месяц сам2	<dact> всегда теплота в.течение весна теплота
всего-навсего студент	маловажный студент студент2	маловажный хз2 студент2
в полдень студент распахнуть окно и выглядывать в сад	день <nums> день студент2 открытый окно открытый видеть	день <nums> день студент2 открытый окно открытый видеть
осень ребенок надевать штаны сапог куртка и брать зонтик	осень дети одеться брюки сапоги куртка зонт <dact>	осень дети одеться брюки сапоги куртка зонт <dact>
луиза очень привязываться к девочка но удерживать она не мочь не иметь право	<dact> учить2 очень привязываться девочка н-о держать не.	<dact> учить сильный любить девочка н-о держать не мочь нет3 право
антон пылесосить ковер и выкидывать мусор а дедушка например помогать бабушка и заниматься внук учить антон играть в шахматы а катя читать е любимый сказка	<dact> пылесосить плоский <dact> выкидывать пример дедушка 1ps помогать 3ps бабушка	<dact> пылесосить плоский <dact> выкидывать пример дедушка 1ps помогать 3ps бабушка2 заниматься <dact> если трудно обучать2 <dact> обучать2 шахматы <dact> читать любить сказка
двигаться в правильный направление в пищевод это называться пищевой желоб	clf clf.двигаться направление правильный еда жевать2 внутренний <dact>	clf clf.двигаться направление правильный еда жевать2 внутренний <dact> назвать еда <dact>
хотеть немного подробно вы рассказывать чтобы кто-то быть полезный	немного желание подробный рассказывать открытый изучать все быть полезный	немного желание подробный рассказывать открытый изучать все быть полезный
я уметь красиво писать	1ps знать красивый писать	1ps красивый написать мочь2
на поляна нет гриб	территория гриб нет2	территория гриб нет2
разрушать	разрушать	разрушение2
однако встречаться различный проблема и непонятно как двигаться далеко	дальше тупикpl	дальше тупик pl как
если сдерживаться невозможно у вы быть пара минута чтобы добегать до туалет и расслабляться	если сдерживаться не.нужно у 2ps есть <nums> минута что добегать	сжатый не.мочь clf clf.чуть минута.две минута.три давать что до туалет бег2 место все4
но ты спас я жизнь	н-о 2ps спасать 1ps жизнь	н-о 2ps спасать poss 1ps жизнь
тот же фамилия и у бабушка с дедушка ведь она переходить папа от они	одинаковый фамилия бабушка2 дедушка poss 3ps родители передать 3ps перед	одинаковый фамилия бабушка2 дедушка poss 3ps родители папа потому что папа передать 3ps передать 1ps фамилия свой родители
я тоже хотеть носить красивый платье	1ps тоже желание носить платье красивый	1ps тоже желание носить платье красивый
поэтому запасаться полезный продукт и поехать	это собирать2 подготовка и начинать	это собирать2 подготовка собирать2 и начинать
ну весь золушка теперь ты мочь ехать во дворец	все золушка 2ps мочь уезжать дворец	все сейчас <dact> 2ps мочь уезжать дворец
очень мало человек заниматься программирование	программирование дефицит <nums> человек меньше	программирование дефицит <nums> человек все2
также плохой труба и канализация где протекать плохой вода и из кран так же бежать плохой и ржавый вода	плохой труба <dact> грязный труба <dact> clf clf.течь clf	это плохой вода труба <dact> clf clf.течь clf.из clf.крана грязный ржавчина труба pl плохой <dact>
я нравиться общаться с людьмиб интересно узнавать что случаться	1ps pl нравиться общаться человек интересный узнать случай что	1ps pl нравиться общаться человек интересный узнать случай что
весь время они играть и гулять вместе как друг мальчик заболевать	все время 3ps pl гулять разнообразный вместеpl друг мальчик болезнь	вместе pl игра гулять разнообразный вместе pl вдруг 2ps мальчик болезнь
бывать что катя и антон ссориться но потом обязательно мириться	быть <dact> <dact> ссориться н-о потом мир2	<dact> <dact> быть pl ссориться быть pl н-о потом обязанность мириться
когда человек начинать кашлять хвататься за горло что мы должный сделать как должный помогать	человек начать кашлять2 задыхаться2 что мы должен что 1ps pl должен	человек начать кашлять2 задыхаться2 кашлять2 что мы должен 1ps помогать 3ps какой должен был
этот чай работать как антиоксидант бороться с некоторый процесс в организм	это а <dact> работать2 алюминиевый.организм clf.процесс так	<dact> indx работать2 как <dact> как против организм что есть
он слушать когда говорить и понимать	3ps слушать говорить2 понятый	3ps слушать говорить2 indx понятый
главное чтобы он действительно представлять то как бы он хотеть чтобы быть	главный 3ps должен представить3 <dact> 3ps желание что был	главный 3ps должен представить3 <dact> 3ps желание что был
второй совсем не принимать	второй совсем взять не	следующий3 второй совсем взять не
они часто приходить на берег и плавать прыгать в вода	двое часто приходить берег плавание clf clf.берега clf.	двое часто приходить clf clf.берег плавание clf clf.с clf.берега clf.прыгать clf.в clf.воду
я любить красный помада	красный губная помада 1ps любить	губная помада 1ps любить красный
я не хотеть выступать на концерт	концерт сцена принимающий участие не.хотеть	концерт сцена принимающий участие не.хотеть
без вы у я на сердце тоска	без 2ps сердце чувствовать грусть	без 2ps сердце чувствовать грусть
желчь	<dact>	<dact>
давать разбираться зачем мы есть	пробовать исследовать почему мы еда почему	пробовать исследовать почему мы еда почему
привет друг я звать андрей	привет другpl 1ps имя <dact>	привет друг pl 1ps имя а-й
каков причина этот проблема у глухой	причина2 причина2 indx глухой	проблема2 глухой indx причина какой
старуха удивляться	старый удивляться	удивление старый
достоинстно	достоинственно	гордость
сейчас я заниматься инскусственный интеллект т е то как он распознавать жестовый язык и переводить он в текст такой вот у я тема	1ps тема2 какой это <dact> <dact> это <dact> <dact> это для2 poss 3ps <dact> говорит	indx тема2 какой это <dact> какой это <dact> <dact> это для2 poss 3ps <dact> говорить на жестовом языке 3ps воспринимать 1ps говорить на жестовом языке 3ps воспринимать 1ps переключаться написать использовать искусственный.интеллект внутри тема2
переходить к тема	перейти <dact>	clf clf.отодвинуть тема2
счастливый	счастливый	счастливый
каков причина	причина2pl	причина2 pl какой
пожалуйста научать жестовый язык	пожалуйста учить3 1ps мочь2 школа пожалуйста жестовый.язык2	пожалуйста <nums> учить3 1ps мочь2 школа пожалуйста жестовый язык
и на розовый куст на самый верхний побег начало распускаться великолепный роза	цветок и clf clf.кусты clf.дерева самый верхний	кусты розовый цветок кусты clf clf.побег clf.растения начинать clf clf.распускается clf.цветок красивый шикарный цветок
если быть учитель наставник то продвижение быстрый будет потому что ты учить и сопровождать да	если быть учитель наставление быстрый 2ps учить поэтому и сопровожд	быстрый будет карьера indx опыт есть 3ps учить 1ps 1ps заместитель да
вопрос такой вы уже переболеть	вопрос 3ps уже переболеть	вопрос 3ps 1ps заболеть уже
если бы я не становиться переводчик я заниматься бы продажа быть бы экономист	если 1ps переводчик нет2 1ps продажа экономика2	если 1ps переводчик нет2 б-ы был продажа экономика2
аплодисменты	аплодисменты	аплодисменты
бывать низко температура	быть высокий температура	ниже быть <nums> ниже
главное смотреть на то как выглядеть волос и что вы нужно на каждый день	главный вы смотреть желание clf clf.волосы clf.торчат	главный вы смотреть чувствовать clf clf.волосы clf.тяжелые что вы необходимость каждый день
далеко договариваться с государство а оно просить взятка	дальше договариваться государство <dact> взять	следующий пример государство 1ps pl договор государство беседовать взятка
как пить капсула фуд контрол	как таблетка <dact> <dact>	как таблетка <dact> <dact> как
при пережевывание еда распадаться на кусочек чтобы организм быть легко нужный слюна она смешиваться с еда и расщеплять она	когда2 еда еда clf clf.распадаться clf.	когда2 жевать2 еда clf clf.распадаться clf.кусок что организм легко2 нужно <dact> clf clf.смаковать еда жевать2 исчезать
весь крепко и крепко прижиматься соловей к шип и песня он звучать весь громко и громко ибо он петь о зарождение страсть в душа мужчина и девушка	imp держать clf clf.прижиматься clf.телом clf.	птица2 clf clf.прижиматься clf.телом clf.к clf.шипу песня кричать птица2 это о-н песня о появляться эмоция все включено мужчина2 и девочка
я хотеть выступать на концерт	1ps желание выступать концерт	1ps желание принимающий участие концерт
почему выбирать это число	число выбрать почему	число выбрать почему
в концертный зал кто-то быть	концерт зал кто есть	концерт зал <dact> кто есть indx
лето расти вкусный яблоко	лето расти вкусный яблоко	лето расти вкусный яблоко clf clf.есть clf.яблоки
вот значит ствол дерево это возникать проблема нужно узнавать каков е причина и какой оказываться последствие	indx indx ствол дерево indx проблема2 indx причина <nums> что какойpl indx	indx indx дерево clf clf.ствол clf.дерева indx проблема2 indx причина <nums> что какой pl indx результат итог
они предлагать такой рабочий место куда человек с инвалидность не мочь устраиваться	3ps предлагать рабочий место куда инвалид вступить.не	3ps предлагать такой работа место куда инвалид вступить просто не.мочь
они уничтожать танк противник с то чтобы обеспечивать дальнейший продвижение пехота	танк уничтовать что clf clf.люди двигаться	танк уничтовать что clf clf.люди двигаться
мой мама ой мой папа закаляться не знать каждый день чтобы не заболевать обливаться хлодный вода ну знать стоять под холодный душ	poss мама poss 1 папа 3ps не знать каждый день что болезнь нет clf clf 	poss1 мама poss1 папа <dact> не знать каждый день что болезнь нет clf clf.обиваться холодно не знать душ
пока	пока	прощаться
трудный	трудный	трудный
я часто слушать история на ваш канал и теперь решать поделиться свой	часто слушать история poss 2ps и решать разделение 1ps собственный	часто слушать история poss 2ps программа и решать разделение 1ps делиться 3ps собственный
в итог никакой поступление энергия нет	результат это множественный электричество <dact> внутри.себя нет2	и ждать2 электричество тратить успех тоже нет2 запас
рубль нет даайт посмотреть что туда входить	<nums> рубль нет2 <nums> рубль нет2 даайт смотреть	<nums> рубль не <nums> рубль нейтр.имп смотреть входить.во.что-то что
я тоже понимать что уже не мочь без он	1ps сам2 думать что без 3ps 1ps не мочь	1ps сам2 думать что без 3ps 1ps не мочь
поэтому она открывать страница в Instagram о рыжий кот где рассказывать история о бобо который недавно выходить на пенсия	поэтому открывать instagram2 страница рыжий кот о когда2	поэтому рыжий кошка3 <dact> открывать instagram2 страница рассказывать история <dact> 3ps совсем недавно уже выходить пенсия
если не получаться то во время реанимация инородный тело оно пройти в один из бронх и тогда один из легкий смочь дышать дыхание будет частичный не в полный объем	если успех не.хотеть время <dact> clf clf.инородный clf 	если получаться нет т-о в-о время реанимация может.быть поперхнуться бронхи <dact> clf clf.инородное clf.тело clf.сдвинуться удача <nums> легкое удача пустой будет дышать н-е полный н-о часть будет
крепко прижиматься ко я милый соловушка не то день прийти рано чем заалеть роза	imp приближенный clf clf.шип clf.протыкает clf.тело	clf clf.тело дорогой птица2 если день начинать заранее красный изменять не.успевать
он не уметь кататься на лыжа	о-н мальчик 3ps не мочь кататься.на.лыжах	о-н мальчик 3ps не мочь не знать кататься.на.лыжах
и вот мы сыграть свадьба и я переезжать к он у они быть три комната в квартира	вместе свадьба 1ps переезд у 3ps indx все включено квартира у 3ps был	вместе свадьба 1ps переезд у 3ps indx все включено квартира у 3ps был <nums> комната pl clf clf.комнаты
мочь быть будет кто-то с кохлеарный имлант	мочь быть кто кохлеарный.имлант	может быть кто есть к-и кохлеарный.имплант
обязательно быть ошибка а расчет примерный	должен первый ошибка а расчет	должен ошибка pl clf clf.уровень clf.разный примерно сравнить пример рассказывать
раздражать этот бесконечный ветер	раздражать всегда ветер раздражать	раздражать всегда ветер раздражать
чтобы не заболевать я делать зарядка	что болезнь нет 1ps делать зарядка	что болезнь нет 1ps делать зарядка2
кролик обращаться а я рано не быть настоящий	кролик обратиться 1ps раньше не был настоящий	кролик обратиться indx раньше2 не.был настоящий не.был
лето можно играть в песочница лепить кулич из песок	лето мочь игра песок делать пирожокpl делать песок	лето мочь игра песок делать пирожок pl делать песок
я самый трусливый и самый слабый из весь животное	1ps сам2 трус и сам2 слабый2 вокруг животноеpl	1ps самый3 трус и самый3 слабый2 и-з животное pl
главный задача угвеод обеспечивать мы быстрый энергия во-первых белок и жир организм усваивать в определенный количество а угвеода приниматься в любой количество	главный <dact> 3ps давать 1ps быстрый электричество почему пример <dact> <dact> это внутри.	<dact> это 3ps давать 1ps быстрый электричество почему пример <dact> <dact> это внутри.себя воспринимать точно сколько 1ps нужно лишний не.нужно воспринимать а <dact> все любой получать pl воспринимать
он ездить на автобус	автобус ездить автобус	о-н ехать.на.транспорте автобус автобус
если у вы волос торчать то и вы хотеть они сглаживать то нужно использовать коллаген шелк кератин и белок	если у 2ps pl волосы clf clf.торчат clf clf.сгла	если у 2ps pl волосы clf clf.волосы clf.торчат clf clf.волосы clf.торчат желание clf clf.сглаживать что что необходимость использовать <dact> <dact> <dact> <dact>
живот сообщать мозг и он понимать ой да да да где здесь туалет	животное 3ps знать 1ps да где	живот indx сообщение 1ps мозг возникать понимать да pl тулет искать
тема будет очень интересный о переводчик какой он должный быть какой качество должный обладать и т д	тема2 какой очень интересный о переводчик должен быть какой	тема2 интересный о человек2 переводчик какой должен был какой качественный какой правила2 что пример список2 исследовать будет
потому что когда вы начинать делать что-то в ущерб себя вы начинать ненавидеть тот для кто это делать	например 1ps себе заставлять3pl ненавидеть2	например 1ps себе заставлять3 pl похоже 1ps начинать человек pl ненавидеть2
он встряхиваться отчего мышонок упасть на земля	clf clf.птица clf.открытые clf.глаза clf 	трястись2 мышь2 падать2 н-а земля
и давать направление действительно нужно развивать	нужно направление действительно нужно развивать	и это направление действительно нужно развивать
я премия не давать	премия давать	премия давать 1ps не был
чуть в легкий не попадать	clf clf.чуть легкие попал	indx clf clf.чуть легкие попал clf clf.чуть
вот например весь знать проблема глухой работа и т д	пример проблема2 все знать проблема2 глухой работа и что	1ps пример проблема2 глухой все самый знать проблема2 работать перечислять2
нужно делать шаг	нужно делать шаг	необходимость шаг pl
сжимание стенка называться перистальтика	clf clf.стенки clf.сжиматься назвать <dact>	clf clf.стенки clf.пищевода clf.сжиматься назвать <dact>
а человек заложник потом отпускать	брать.за.руку уводить	брать.за.руку уводить да
сразу невозможно быть получать	indx <nums> не.мочь.сделать исчезать	indx <nums> любой толпа получать не.мочь.сделать
в трудовой ресурс зарплата такой же как в материальный	трудовой ресурс зарплата все есть	зарплата труд тоже indx мочь ждать
мой брат не любить шоколад с то момент как отравляться он	poss 1ps брат не.любить шоколад с то момент какой отравляться	когда2 3ps poss <nums> брат яд шоколад после2 это не.любить шоколад
я весь этот три день участвовать рассказывать защищать свой проект сказать что у я уже быть письмо поддержка например от музей балл быстро подсчитывать и это быть успех	1ps <nums> день <nums> это indx защищать 1ps рассказывать 2ps что 1ps indx <dact> есть 3ps	день <nums> это indx 1ps делать 1ps рассказывать 2ps защищать 3ps финал защищать 1ps рассказывать 2ps что 1ps indx <dact> есть 3ps поддерживать 1ps печать indx спонсор все есть известный быстрый <dact> и 1ps успех
смотреть группа из человек это мало человек это много	смотреть <nums> человек группа <nums> человек мало <nums> человек множество толпа	смотреть indx <nums> человек группа <nums> человек мало <nums> человек множество толпа
урок называться наш дружный семья	урок назвать poss 1ps дружба семья	урок назвать poss 1ps pl дружба семья
кто там в новосибирск быть	кто indx indx новосибирск есть	кто indx indx новосибирск есть
а проблема то в то что мы мочь говорить на жестовый один рука а в англия человек так не мочь	проблема2 indx англия жестовый.язык2 один то.же.самое	indx проблема2 indx англия жест только2 fs clf clf.использовать clf.обе clf.руки два говорить на жестовом языке рука один говорить на жестовом языке мочь2 телефон говорить на жестовом языке мочь2 англия нет3
ну если ничто нет давать варить каша из топор	н-у если ничего3 нет2 нейтр.имп. пробовать	н-у если ничего нет2 нейтр.имп. пробовать готовить <dact> и-з топор2
первый раз укусить начинать жевать	<nums> раз <nums> жевать2 начинать	когда2 первый clf clf.укусить начать жевать2
температура то повышаться то понижаться снег мочь то неделя лежать а мочь мало и потом растаивать	температура повышать понижать clf clf.толстый clf.слой clf	температура повышать быть понижать clf clf.толстый clf.слой <dact> <nums> неделя мочь меньше таять
главный дед мороз удивленно посмотреть на он и сказать теперь ты быть не маленький дед мороз а лесной	дед.мороз видеть главный видеть <dact> дед.мороз поменять <dact> что лес	дед.мороз видеть главный видеть удивление дать был <dact> дед.мороз поменять <dact> что лес точно
медвежонок ларсить жить на северный полюс вместе с мама и папа	медведь имя <dact> жизнь место indx северный.полюс мама папа вместе	медведь имя <dact> жизнь место clf clf.шар indx северный вместе родители
в это дом не бывать гость	это дом гость ноль	это дом гость ноль
ошибка считать что можно похудеть быть принимать капсула лежать на диван и ходить по тысяча шаг в день каждый день увеличивать это количество на шаг	может.быть лекарство лежать лекарство лежать лекарство тысяч	все думать лекарство лежать лекарство уже <nums> тысяч <dact> ходить нужно каждый день увеличивать <nums> ходить увеличивать
пожалуйста выбирать то кто по ваш мнение входить в сообщество глухой	пожалуйста выбрать кто 2ps мнение входить poss 2ps мир2 глухой	пожалуйста выбрать pl поставить.галочку выбрать poss 2ps мнение что включать мир2 глухой
весь спрашивать почему на юг так популярный одежда защищать от ветер	все спрашивать о-т популярный одежда3 защита ветер защита	все спрашивать 1ps ю-г популярный clf clf.толстая clf.одежда защита ветер
я в близкий время хотеть сделать опрос о то кто желать становиться глухой экскурсовод экскурсовод для глухой	1ps близкий время желание опрос о кто мечтать будет делать	1ps будет опрос 3ps pl кто желание переводчик глухой <dact> проводить кто желание есть желание
проходить день неделя а она весь мечтать	проходить день проходить неделя желание девочка	желание проходить день проходить неделя
ясный	яркий солнце светлый	яркий солнце светлый
да он мастер форма это у он отнимать нельзя но быть ли у он чувство	да мастер песня качественный интересный у 3ps чувствовать общий есть нет2	да 3ps мастер песня голос2 качественный н-о интересный у 3ps чувствовать общий есть нет2
у они бюджет быть от сто двести тысяча и высоко	<dact> <nums> тысяч ничего3 бюджет был	3ps финансирование2 о-т <nums> тысяча pl и выше
в инкубатор быть свой плюс ты давать помещение оказывать финансовый и юридический помощь оборудование техника много что давать	плюс <dact> indx плюсpl свой плюсpl давать помещение оказывать	это <dact> попадать indx <dact> плюс pl что 3ps давать 2ps комната2 мочь 3ps давать 2ps бухгалтерия юрист помощь множественный что 1ps давать 2ps мочь механизм компьютер
ладно сам доносить	пусть сам2 clf clf.нести clf.на clf.плече	пусть сам2 clf clf.нести clf.на clf.плече
маша не спать весь ночь она готовиться к экзамен	<dact> н-е спать нет все ночь 3ps подготовка экзамен	<dact> н-е спать не все нет с утра до вечера ночь 3ps подготовка экзамен
в магазин быть сыр	магазин <dact> есть	магазин <dact> магазин есть
очень много глухой готовый заниматься л гкие дело	человек много человекpl будет делать хуже дело	человек много человек pl так будет делать хуже дело
но с ветер конечно по-другому	ветер случай другой будет	ветер случай другой будет
гаснуть	clf крылья махать clf самолет взглянуть	clf clf.свет clf.выключить
энергия давать позитивный мышление и жизненный тонус	энергия давать 1ps мысль положительный плюс жизнь возбуждение	энергия давать 1ps мысль плюс pl и жизнь возбуждение
но это мой жизнь	это poss 1ps жизнь	это 1ps жизнь
если я король то ты очень храбрый принц это лес	если 1ps король 2ps очень смелый <dact> лес2	если 1ps король т-о 2ps очень смелый <dact> лес2
эхо понести этот трель к свой багряный пещера в гора и разбудить спать там пастух	приветствовать clf clf.эхо clf.распространяется гора clf clf.	приветствовать clf clf.эхо clf.распространяется гора clf clf.эхо clf.распространяется звук clf clf.эхо clf.распространяется кто пастух indx спать слышать просыпаться
в результат слышать ребенок не давать жестовый язык	результат это слышать дети2 жестовый.язык	какой это н-е давать нет слышащий дети2 жестовый.язык
как это из топор можно сваривать каша	<dact> и-з топор2 мочь готовить <dact>	как <dact> и-з топор2 мочь готовить вопрос
животное встречаться влюбляться с первый взгляд подружиться и помогать друг друг выздоравливать	животное встречаться первый взгляд.друга дружба друг.друга помогать	такой встреча <nums> 3ps 3ps животное2 <dact> влюбиться первый взгляд.друг.на.друга дружба друг.друга помогать 3ps 1ps pl здоровый
быть тот кто смотреть и говорить ну это же так просто и легко не смотреть	кто смотреть2 н-у простой легко2 не.нужно	мочь кто смотреть н-у простой легко2 все4 поэтому кто смотреть не.нужно
нечестный	честный	честный нет
рано он называться иср а сейчас название новый истый	раньше был <dact> <dact> сейчас3 новый <dact>	раньше был <dact> сейчас3 новый <dact>
фрукт уже практически нет	плодpl мало уже	плод pl мало уже
весь ребенок начинать изучать жестовый язык	все ребенок начинать изучать жестовый.язык	ребенок уже начать задавать.вопросы жестовый язык
вдалеке увидеть деревня	смотреть деревня	смотреть деревня далеко3
сам смотреть что вы надо что не надо	сам2 смотреть как нужно что poss 2ps pl что не.нужно	сам2 смотреть как нужно что poss 2ps pl что не.нужно
и он высовываться из окно и сорвать она	студент2 clf clf.высовываться clf.из clf.окна ср	студент2 clf clf.высовывать clf.голову clf.из clf.окна окно clf clf.высовываться clf.из clf.окна срывать clf clf.держать clf.цветок clf.в clf.руке
она быть такой же злой и вредный	характер вредить такой.же.самое	характер такой.же злость вред
вы так беседовать со свой ребенок	2ps pl тоже беседовать дети2	тоже 2ps pl беседовать собственность дети2
делать нужно в определенный модификация	н-о только2 деньги н-о определенный модификация	н-о только2 делать в странный мода
следующий человек потерять слух во взрослый возраст	следующий2 человекpl оглохнуть взрослый	следующий2 человек pl кто оглохнуть взрослый
например первый это грант	пример первый <dact>	пример первый <dact>
мальчик ловить и крупный рыба	мальчик ловить великий рыба2	мальчик ловить великий рыба2
первый это хлопок по спина	первый это clf clf.человек clf.хлопать clf.по clf	первый 1ps нужно спина clf clf.человек clf.выбить clf.инородное clf.тело
как сделать я	как делать 1ps	как делать 1ps
работа в команда похожий на профессиональный спорт	команда indx такой профессионал спорт	indx и почему 1ps говорить объяснять команда indx такой профессионал спорт
здравствовать	здравствуйте	здравствуйте
на этот земля не расти ни кукуруза ни картошка	земля территория расти кукуруза картофель расти не мочь	земля территория расти <dact> картофель расти не мочь
что мы нужно сделать	что мы делать	что мы нужно делать
я быть делиться свой опыт	1ps опыт делить	1ps свой опыт будет 1ps делить советовать рассказ кто 3ps pl жестовый.язык
друг	друг	друг
а у старушка весь быть	а у 3ps старый все есть	3ps у 3ps старый все есть
наслаждение	наслаждение	наслаждаться
я любить сосиска	1ps сосиски 1ps любить	1ps сосиски 1ps любить
ветер здесь до м с	ветер до <nums> м секунда	ветер до <nums> м секунда
нужно изменять себя внутри переставать заставлять себя и жертвовать себя	нужно внутри.себя изменять себе заставлять3 нет2 отдавать.себя	нужно внутри.себя изменять себе заставлять3 нет2 отдавать.себя нет2
необходимо привозить оборудование который предоставлять электричество	необходимость привозить оборудование который предоставлять электричество	необходимость собственность clf clf.взять clf.привезти оборудование электричество деньги clf clf.взять clf.привезти необходимость доставка
ругать	ругать	ругать2
падать снег и быть темно	идет снег был ночь	идет снег был ночь
грубый	грубый	грубый
слышать всегда смотреть на то какой вы команда если сильный вы быть работать	слышащий 3ps pl видеть команда какой 2ps pl если сильный будет	слышащий 3ps pl видеть команда какой 3ps команда сильный будет делать
получаться столбец не связанный слабо связанный средне связанный сильно связанный	получать2 столбец н-е так.себе слабый связать норма	получать2 clf 4.столбца первый здесь связать пустой так.себе связать норма нет2 столбец связать есть н-о так.себе слабый связать есть средний связать крепкий
попадать	clf clf.свет clf.выключить	попасть clf clf.что
я начинать этот занимать в год и обучение там длиться день с утро до самый вечер	1ps начинать работать2 <nums> год и <nums> с утра до вечера учиться	1ps начинать был <nums> indx день <nums> учиться с утра до вечера учиться
и он вернуться к себя в комната вытаскивать большой запылить книга и приниматься она читать	студент2 обратимый домой собственный комната clf clf.книга clf.тяжел	студент2 обратимый домой комната собственный книга clf clf.книга clf.большая clf.тяжелая протирать <dact> протирать и clf clf.открыть clf.книгу начинать взглянуть читать
отношение быть меняться	отношение менять	отношения изменять будет
можно ли в ваш регион подписывать соглашен о трудоустройство человек с инвалидность в другой организация	можно н-о ваш регион подписывать соглашаться о трудоустройство инвалид в	можно л-и poss 2ps регион подпись <dact> о трудоустройство инвалид другой организация
он никогда не быть в турция	турция никогда2	3ps никогда2 турция не был
или если у вы быть знакомый который знать финский жестовый язык передавать он этот информация пожалуйста	или у есть знакомыйpl 2ps знать жестовый.язык2 финляндия 2ps	или у есть знакомый 3ps знать жестовый.язык2 финляндия 2ps передавать пост2 видеть отправлять пожалуйста
подымать	подымать	clf clf.поднимать
я видеть что вокруг много молодой человек школьник который не думать куда поступать а думать куда пойти они друг или куда направлять они родитель	1ps видеть вокруг много молодой и школа 1ps думать куда поступать	так 1ps замечать вокруг много молодой и школа думать 1ps куда поступать брать.пример.с друг родители 3ps заставлять2 1ps
у третьяков быть хобби он быть меценат и оплачивать строительство школа для глухой ребенок выделять целый тысяча на это и в год построить трехэтажный здание школа	третий и <dact> есть хобби 3ps деньги финансирование забота семья школа	и <dact> 3ps <nums> дело хобби 3ps деньги финансирование забота семья школа для глухой <nums> тысяч отправить з-а строить clf clf.здание строить <nums> год этаж <nums> здание
тамара долго идти по почти непролазный дорога и вдруг увидеть дым из труба один из дом она обрадоваться побежать подавать и весь грязный добираться наконец до это дом	<dact> медленно дорога был плохой стремный н-о глаз дом дым	ходить медленно место дорога был неприятный стремный н-о глаз indx дом дым и видеть бежать2 падать2 плакать тело грязь добраться до это indx дом
мы радоваться когда гладить котенок и чужой слово влиять на наш настроение	когда2 радоваться радость когда2 гладить2 например кот indx что глад	когда2 мы радоваться радоваться что видеть например кот indx что гладить2 слово чужой сказать 1ps влиять 1ps настроение
хм а кто же будет кучер	хм кто будет кучер	задуматься кто 3ps будет кучер
там быть мой кворки нажимать создавать кворк	indx <dact> <dact> indx строка создавать <dact>	indx <dact> <dact> indx строка создать <dact>
смотреть как он обучать что нужно добавлять	смотреть2 обучать что необходимость добавить	<dact> clf clf.человек обучать2 что необходимость добавить
мой отец бояться мачеха	poss 1ps папа мама второй бояться3	poss 1ps папа мама второй бояться3 бояться
к сожаление фотография прабабушка и прадедушка родитель бабушка и дедушка не сохраняться поэтому на это дерево весь начинаться с бабушка и дедушка	сожаление фотокамера <dact> дедушка <dact> родитель 3ps родители 3ps бабушка2	сожаление фотокамера <dact> дедушка <dact> бабушка2 отсутствие 3ps родители 3ps бабушка2 дедушка отсутствие сохранять отсутствие поэтому indx дерево все начать бабушка2 и дедушка
ну в общий это вс что я хотеть сказать	все результат 1ps желание сказать	все результат 1ps желание сказать
это желание будет помогать копить	это желание будет помогать копить	это желание 1ps помогать 1ps копить будет
ленивый	ленивый2	ленивый2
муравьед любить кушать насекомое авокадо цитрусовый	<dact> еда птица2 <dact> апельсин <dact> еда обожать2	3ps еда <dact>- паук <dact> апельсин <dact> еда обожать2
зато рейтинг высокий и много заказ а у он все заказ быть отзыв	3ps высший и заказpl много у 3ps 3ps заказ бытьpl <dact>	3ps высший р-е- заказ pl много у 3ps <nums> 3ps заказ быть pl <dact>
когда у маленький дед мороз весь подарок быть готовый остальной вс думать что снова надо будет ехать дарить ребенок подарок возвращаться домой что это очень скучно	когда2 подарок маленький все подарок готовый это ждать все дед.	3ps подарок похоже готово clf clf.коробки clf.расставить готово это ждать все дед.мороз неинтересно опять2 не.хотеть ехать.поездом дети подарок pl назад домой не.хотеть похоже неинтересно поэтому думать обсудить пусть
еще раз хотеть сказать что каждый момент свой жизнь нужно наполнять радость	еще раз хотеть сказать каждый момент свой жизнь нужно наполнять рад	еще раз хотеть сказать каждый момент свой жизнь нужно наполнять радость
костик и мишка сказать тоже где ты быть что с ты приключаться рассказывать	<dact> <dact> 3ps и 3ps тоже где был случай что 2ps рассказывать 1ps	еще <dact> <dact> 3ps спрашивать 1ps тоже где был случай что 2ps рассказывать 1ps
семен по путь с работа забирать дочка из садик и к ужин они всегда быть дом но не в этот злосчастный день	<dact> работать clf clf.человек clf.идет 3ps забирать 3ps дочь	<dact> работать clf clf.человек clf.идет 1ps забирать 3ps дочь и-з дети <dact> и вечер всегда2 домой еда стол н-о попадать день беда
и по свисток начинать собирать человек на съезд в москва начинаться беготня в общий постанавливать собирать человек в москва в июль год	и свистеть начинать clf clf.люди clf.собираются	и свистеть начинать clf clf.люди clf.собираются clf.в clf.одном clf.месте съезд москва попал беготня общий постановить clf clf.люди clf.приходят москва <dact> <nums> год2 <dact> clf clf.люди clf.приходят
как жираф	жираф похоже	жираф похоже
смотреть результат быть	смотреть результат был	смотреть иметь результат
краудфандинг	<dact>	<dact>
когда вы себя насиловать унижать у вы нет уважение к себя вы не в состояние что-то давать	похоже отдавать.себя себе унижение себе уважать себе уважать нет2	похоже отдавать.себя себе унижение себе уважать 1ps нет2 похоже 1ps не мочь давать pl
однажды они зайти в лесной глушь	вдруг лес глушь	вдруг лес внутри
мама он сразу начало учить я жизнь что я должный муж беспрекословно во весь слушаться и сразу выполнять весь что он требовать	мама 3ps начинать учить2 1ps жизнь что 1ps муж должен был послушный2	мама poss 3ps начинать 3ps учить2 1ps <dact> жизнь что 1ps муж должен был послушный2 3ps заказывать 1ps 3ps приказать 1ps 3ps требовать 1ps 1ps выполнить
я работать уже давно с начало создание адаптиса	1ps работать2 долго <nums> начинать создание2 <dact>	1ps стаж2 давно все4 работать2 когда начинать создавать2 sn
без знание жестовый язык этот ребенок не являться CODA	жестовый.язык не.знать слышащий кода нет 3ps	жестовый.язык не.знать считать2 н-е кода нет 3ps
нордис в г новосибирск	<dact> новосибирск здесь	<dact> новосибирск здесь
благодаря плодоножка вишня в организм не накапливаться лишний жидкость а в жировой ткань активизироваться процесс микроциркуляция	благодаря плодоножка вишня indx внутри.себя накапливаться лишний	еще clf clf.плодоножка indx indx н-е 3ps давать 1ps добавлять жидкий лишний внутри.себя и активный промежуток.времени управлять <dact> внутри.себя ткань
они поехать в приют и предлагать вместе с они собака пойти на долгий прогулка	3ps поехать <dact> приют 3ps предлагать вместе собака и гулять долго	<dact> поехать место <dact> и нейтр.имп вместе собака poss 3ps забирать и гулять долго
я вс учитывать и тогда я получать удовольствие от работа потому что она быть в кайф	1ps учить2 1ps н-о 1ps деньги 3ps желание о-	1ps все считать2 и 3ps pl удовольствие 1ps работать почему indx кайф3
вообще весь человек журналист ленивый	все журналист все человекpl ленивый все	все журналист все человек pl ленивый все
я удаваться оформлять кредит благодаря то что в банк к мой проблема относиться с понимание	1ps мочь2 оформлять кредит благодаря понимать 1ps poss 1ps проблема2	1ps мочь2 оформлять кредит почему благодаря понимать 1ps есть проблема2
готовый	готовый	готовый
потом няня становиться жалко кролик но доктор сказать надо сжигать и давать новый	потом няня смотреть жалость кролик доктор2 надо спрашивать доктор да	потом 2ps няня2 смотреть жаль врач2 спрашивать доктор2 indx кролик indx так огонь новый давать
но вы сам понимать что связь у я не так много но то не менее шанс уже быть у вы быть шанс получать помощь	н-о у 1ps понимать зависеть мало временный есть 2ps pl есть шанс	н-о у 1ps понимать2 зависеть мало временный есть 2ps pl <dact> есть радость 2ps спрашивать 1ps
и плюс всегда развиваться учиться идти вперед	плюс всегда лучше учить2 развивать	и плюс всегда развитие учиться идти.вперед
и если милиция я не находить	и если милиция 1ps 1ps искать н-е еда не был	вдруг indx милиция 1ps 1ps искать 3ps успех нет
спонсор готовый платить я выполнять проект в это город нехватать мыло я сообщать спонсор получать мыло и раздавать	платить2 согласие платить2 1ps выполнять проект indx город indx не.хватать	платить2 согласие постоянный платить2 1ps проект выполнять сдать pl город indx не.хватать 1ps объявлять 3ps clf clf.взять clf.мыло сдать pl
сейчас глухой начинать активно заниматься индивидуальный предпринимательство и это плюс потому что они становиться независимый	все и-п мочь плюс заниматься <dact> плюс это независимый	все и-п мочь indx плюс потому что свой зависимость не
они наблюдать и чувствовать что необходимо создавать общество для ребенок CODA	3ps pl наблюдать общество для ребенок чувствовать что необходимость создавать2	смотреть pl чувствовать что нужно создавать2 общество группа для кода
либо где можно находить спонсор чтобы получаться сокращать количество деньги и расход быть по ноль	или где можно находить спонсор что составлять получаться деньги кратко расход	или где можно находить спонсор что составлять получаться деньги кратко расходы ничего
кто-то печ т торт кто-то фотографировать работать в такси и развивать автопарк кто-то заниматься ремонт	кто торт печь кто фотография2 достигать кто такси подготовка автомобиль <dact>	кто торт печь кто фотография2 достигать кто такси подготовка автомобиль <dact> развитие кто ремонт
я очень рад что быть выбор профессия специальность	1ps очень радостный есть выбор профессия специальность	1ps очень радостный есть выбор профессия специальность
она помогать она заниматься научать готовить печь шить они часто вместе гулять ходить в музей и на выставка	помощь это обучать2 готовить пирог шить вместе часто прогулка	помощь учиться 1ps учить2 3ps готовить пирожки пирог шить вместе часто прогулка музей выставка смотреть2
также от до процент калорийность идти на пищеварение	еще о-т <nums> до <nums> процент калорийность идти	еще о-т <nums> до <nums> процент <dact> мы тратить н-а пищеварение
многий из они еще и работать переводчик в вуз	и 3ps pl много посетить переводчик работать посещать.и.то.и	и 3ps pl переводчик много посетить <dact> переводить работать посещать.и.то.и.это
встреча	встретить	встретить
я говорить что нужно сюда а он в другой место доставлять	1ps доставка 3ps 1ps не indx	1ps не 1ps indx доставка 3ps 1ps 3ps не indx
гость ничто не купить к чай	гостьpl ничего3 деньги не <dact> чай	гость pl ничего3 деньги не <dact> чай indx
это он собака	это собака	это poss 3ps собака
да да постоянно калька	да да калька2pl	да да калька2 pl
я состоять в ассоциация слышать гид	1ps слышать включать слышащий включать гид	1ps есть включать содружество <dact> проводить <dact> слышащий включать
дом красиво украшаться весь делать друг друг подарок вместе играть и танцевать	дом красивый украшать все подарокpl друг.друга игра танцевать	дом красивый украшать все делать подарок подарок2 все семья игра танцевать
мы отда м себя полностью и жд м любовь к себя	отдавать.себяpl ждать2 любить себе	отдавать.себя pl ждать2 любить себе
важный использовать бальзам если волос повреждать и торчать	<dact> clf clf.волосы clf.торчат получаться clf clf.вол	бывает clf clf.волосы clf.торчат получаться clf clf.волосы clf.повреждены волосы clf clf.волосы clf.повреждены получается clf clf.волосы clf.повреждены сломанный clf clf.волосы clf.торчат получаться
не ловко ну да ладно	неудобно2 ладно	неудобно2 ладно
как это на жестовый передавать	жест как передавать	жест как передавать
солдат посолить и снова попробовать	солдат новый уже clf clf.вылезти clf.на clf.	солдат немного солить новый пробовать
ведь это самый настоящий кошмар	страшный будет	страшный будет
допускать к вы приш л пациент со свой проблема и вы выяснять что у он быть психосоматический влияние	случай пример человек clf clf.человек clf.приближается у 3ps есть	случай пример человек clf clf.человек clf.приближается у 3ps есть проблема2 3ps видеть что у 3ps есть мозг <dact>
выделять деньги на школа	выделять деньги н-а школа	школа clf clf.выделять clf.деньги
когда вы чувствовать себя хорошо и человек вокруг вы чувствовать себя хорошо уровень жизнь качественно поменяться	н-о 2ps pl хорошо когда2 2ps pl себя чувствовать хорошо	1ps хорошо 1ps делать для 3ps pl <dact> себе приятный все себе чувствовать хорошо жизнь уровень изменять
давать поговорить по душа	нейтр.имп. общаться душа	нейтр.имп. общаться душа
у он быть одежда	одежда2 у 3ps есть	одежда2 нет одежда2 у 3ps есть
на следующий день они вдвоем встречаться с орел	следующий день двое встреча орел встреча	следующий день двое встреча орел встреча
я из семья глухой мой мама и папа глухой	1ps семья глухой poss 1ps мама папа глухой	1ps семья глухой poss 1ps мама папа глухой
спрашивать у лощадь как быть всегда вместе с мальчик	спрашивать у лошадь вместе мальчик	обратиться мальчик вместе indx нет
когда быть просить мало деньги то и грант вы легко давать	деньги мало просить деньги мало грант легко	<dact> деньги мало просить деньги мало грант легко
находить	находить	находить
састье слышать	счастье слышать	счастье слышать
говорить	говорить	говорить
вога кормить себя плюс еще инвалид кормить	<dact> <dact> себя 1ps кормить 1ps плюс еще инвалид кормить 3ps	indx <dact> себя 1ps кормить 1ps плюс еще инвалид кормить 3ps
когда знать что быть резерв на душа спокойно а когда потратиться переживать лишний раз вдруг увольнять	когда2 знать что будет спокойный желание переживать желание	знать копить indx 1ps на.душе.спокойно 1ps выбросить переживать вдруг уволить думать лишний
я всерьез это никогда не воспринимать но когда увидеть он возмужать взрослый почувствовать как защемлять сердце	1ps <dact> воспринимать нет и видеть сегодня2 взрослый 1ps нравиться	1ps <dact> серьезно воспринимать нет и видеть сегодня2 взрослый 1ps нравиться
мужчина схватывать чемодан в один рука сумка в другой и на ход потому что поезд уже начинать медленно ехать вскакивать на ступенька	мужчина схватывать clf clf.взять clf.сумка clf 	мужчина2 взять <dact> clf clf.сумка clf.взять сумка clf clf.бежать что поезд начать clf поезд ехать и clf clf.человек clf.прыгнуть ступенька
деньги я не давать но выписывать рекомендательный письмо письмо поддержка начальство поставлять печать	1ps согласиться письмо поддерживать согласиться заполнять администратор печать качественный clf clf	1ps согласиться письмо поддерживать согласиться заполнять администратор печать качественный clf clf.держать clf.письмо clf.в clf.руке хорошо
в конец июнь начало июль уже созревать вишня черешня абрикос	начинать июнь начинать июль indx вишня <dact> <dact>	clf clf.плод clf.pl готовый последний3 июнь начинать июль indx вишня <dact> <dact>
сахар в кровь расти а вслед за этот расти и количество инсулин	сахар indx расти а вслед расти меньше <dact> расти	сахар в красный увеличивать множественный и плюс множественный <dact> добавлять pl
не то чтобы он не хотеть я слушать но просто он вс это быть безразлично	н-о 3ps н-е 3ps не хотеть 1ps слушать н-	мальчик н-е только не хотеть 1ps слушать тоже 3ps безразличие
он думать лишь о музыка а всякий знать что искусство эгоистично	3ps думать только2 о музыка все знать искусство <dact> только2 дума	3ps думать только2 о музыка все знать искусство indx только2 думать о себя pl
а ефросинья петровна надо я видно просыпаться от это грохот	<dact> бабушка <dact> и-з территория clf clf.разрезать clf 	<dact> <dact> открыть.глаза
можно делать сковоречник	мочь делать дом для птица	мочь делать дом для птица
когда реб нок чувствовать что он не один он начинать по-другому относиться к свой родитель открываться он	когда2 ребенок чувствовать что н-е <nums> нет а 1ps родители	1ps <nums> нет 1ps чувствовать открытый и начать относиться папа п-о другой
очень довольный	очень хорошо	очень довольно
за этот три год в инкубатор вы расти и становиться сильный но кроме этот пункт который я уже объяснять быть и другой способ получать деньги на свой проект	indx год <nums> выпускать2 <dact> уже clf clf.новость clf.у	год <nums> выпускать2 <dact> родиться больше уже сильный выпускать2 это множественный мочь другой талантливый 2ps проект есть все включено делать карьера
я звать елена	здравствуйте имя <dact>	здравствуйте 1ps имя <dact>
утом помогать запускать обмен вещество на максимальный скорость работа щитовидный железа давать прилив энергия и хороший настроение а вечер наоборот успокаивать настраивать на хороший сон и защищать от обжорство и ускорять расход жир из наш запас	утро помогать 1ps clf clf.процесс clf.на максимальный скорость clf	утро помогать 1ps clf clf.организм clf.процесс clf.начать максимум скорость clf clf.организм clf.процесс clf.работать работать2 щитовидная.железа ш clf clf.щитовидная clf clf.организм clf.процесс энергия clf clf.организм clf.процесс и настроение хорошо а вечер2 наоборот успокоить слабость спать хорошо защищать о-т еда pl нервный отсутствие <dact> тратить запас быстрый
ну вот же у ты готовый ответ	готовый ответ	готовый ответ
я заканчивать учиться пойти работать туда где быть глухой	1ps учиться работать2 место глухой	1ps учиться конец поступать2 работать2 место глухой
вот	вот	здесь
потом я подзывать свой ребенок который знать жестовый язык он весело подходить ко я	потом это 1ps подзывать 1ps дети 3ps знать жестовый язык 3ps начинать	потом ребенок poss 1ps ребенок нейтр.имп ребенок оживленный нейтр.имп 1ps жестовый язык знать clf clf.подойти нейтр.имп
начинать дуть ветер	ветерpl начинать	ветер pl начинать
в холодильник нет еда	холодно indx еда нет2	холодно indx еда нет2 ноль скелет2
что же делать	что делать	что делать
ты бояться даже ветер	2ps бояться даже ветер	2ps бояться даже ветер
в понедельник мы быть проводить прямой эфир	завтра будет проводить прямой эфир	у 1ps будет понедельник завтра будет проводить п-э
Ещ дедушка с антон хотеть сделать семейный древо	следующий2 дедушка желание делать дерево ветвьpl семья	еще дедушка вместе <dact> желание делать дерево ветвь pl семья
семья это сложный но жить один невозможно	семья это сложный н-о счастье жить <nums> невозможный	семья это сложный н-о счастье жить <nums> невозможный
конечно нужно чтобы кто-то вызывать скорый помощь	н-о вдруг 1ps кто помощь вызывать нужно	конечно нужно чтобы кто заметить indx вызвать <nums>
тома находить в себя сила прощать муж хоть и даваться она это нелегко	<dact> начинать ходить себя сила прощать мальчик муж действительно был тяжелый	<dact> успех себя сильный прощать2 мальчик муж действительно был тяжелый
работник китайский магазин в нью-йорк взять он в магазин и он оставаться там на год	работник китайский магазин нью-йорк взять работник китайский	магазин нью-йорк китай магазин взять и оставить <nums> время
вечерний капсула пролонгировать лимфодренажный эффект получать на первый шаг	вечер капсула indx <dact> прогреметь жидкий 1 <dact> был 3ps давать	вечер капсула indx <dact> жидкий 1 <dact> был 3ps давать 1ps indx управлять clf clf.выравнивать
да вредить	наносить.вред	наносить.вред
борис джонсон болеть в март	<dact> <dact> заболеть был <nums> март	3ps <dact> <dact> заболеть был <dact>
сестра пойти на бал а я нет	сестра двое уезжать бал 1ps не будет	сестра двое уезжать бал 1ps не будет
в мой город нет аэропорт	poss 1ps город аэропорт нет2	poss 1ps город аэропорт нет2
мочь быть я смочь взламывать сенсор ааа он на работа	мочь быть 1ps взламывать сенсор аа работа	мочь 1ps мочь сломать clf clf.сенсор clf clf.стучать 2ps работать2 занято
узкий	узкий	clf clf.тонкий
вот уже не думать что из топор такой вкусный каша мочь получаться	<dact> у-ж н-е думать не что и-з топор2	<dact> у-ж н-е думать не что и-з топор2 так хорошо <dact> мочь готовить
вс вокруг начинать зеленеть и цвести птица прилетать	все круговое движение зеленый и птица2 начинать	все круговое движение начать зеленый начать цветы птица
а однажды в ателье зайти женщина в возраст она долго рассматривать я задавать вопрос а потом сказать что быть бы неплохо она сын познакомиться с такой девушка	а вдруг indx женщина в возраст indx женщина2 долго clf clf.с	и вдруг 3ps входить 1ps женщина возраст и пристальный взгляд 3ps вопрос.задавать 1ps потом 3ps отвечать 1ps б-ы poss 3ps сын 1ps девочка соединять знакомить
девочка она не понравиться	девочка мама нравиться нет	девочка мама смотреть не нравиться
в предыдущий видео мы говорить о то что мы потреблять слишком много разный вкусный еда но организм не мочь потратить весь этот энергия	предыдущий видео о только2 еда множественный 2ps pl потреблять	давно видео2 мы 1ps рассказывать 2ps что еда множественный еда некоторый вкусный а тратить indx электричество внутри.себя не мочь уже
легкий	легко	легко2
познакомиться я предлагать и я становиться заниматься резьба	знакомить 1ps предлагать 1ps 1ps заниматься резьба2	знакомить 3ps предлагать 1ps 1ps заниматься резьба2 карьера
когда в первый раз участвовать совсем ничто не понятно	когда2 первый раз <nums> понятный	раз <nums> куда не понимать первый второй третий
у крашеный волос цвет исчезать	волосы что цвет3 исчезновение	волосы что крашеный цвет3 исчезновение
давать ждать	нейтр.имп ждать2	нейтр.имп ждать2
вопрос вводить ли свой ребенок в сообщество глухой приводить ли на праздник участвовать ли в мероприятие	вопрос 2ps вводить свой дети вокруг глухой проводить мероприятие праздник уча	вопрос 2ps свой дети 2ps включать мир2 глухой проводить мероприятие праздник участвовать
самый плохой что это в климат краснодарский край это ветер	indx сам2 плохой что indx климат краснодар территория ветер	плохой крупный что indx климат краснодар территория ветер
спать далеко это я дениска	продолжать indx дяска	какой спать продолжать 1ps <dact> имя
я заходить в строка продавец туда заходить	1ps зайти строка продавец	1ps зайти строка продавец
рассказывать про человек про то как я здесь рождаться и про вс остальное	рассказывать человек <dact> тоже 1ps рождаться и жизнь все	будет о человек pl разнообразие 1ps здесь родить много разнообразие рассказывать будет
весь и у я быть удобный защитный средство	все4 и себя есть удобный защита прятать	все4 и себя есть удобный защита прятать защита
весь другой животное очень взволноваться	все другой животноеpl очень волнение2	все другой животное pl очень волнение2
он просто оглушать я	слышать звук	слышать звук
после урок идти к ребята	когда2 урок идти к дети	поздно урок приходить дети <dact>
так вот третьяков построить трехэтажный здание школа а рядом еще больница построить	indx третий третьяков этаж <nums> и больница2 clf clf.	3ps т-у создавать2 этаж <nums> и больница2 был строить clf clf.расположение clf.объектов clf.в clf.пространстве
почему это слово код являться популярный во весь мир	почему это слово <dact> популярный2 мир2	почему это слово <dact> популярный2 <nums> называть мир2
хорошо пока	хорошо пока хорошо	хорошо пока хорошо
мать обещание не сдерживать и после окончание школа оля уезжать в чужой город и там и оставаться	мама 3ps алкоголь нет2 проходить школа indx уезжать другой чужой город	мама 3ps алкоголь и проходить школа <dact> уезжать другой чужой город и indx зафиксировать
к пример я экскурсовод кто не приходить человек так называть экскурсант	представление <dact> <dact> кто человек приходить человекpl назвать <dact>	представление 1ps <dact> clf clf.толпа clf.движется clf.loc 3ps имя называть <dact>
я под кровать за двадцатьлет не то что созревать я там вполне перезревать	1ps лежать время 1ps детство уже уже уже изменять уже	1ps лежать <nums> время 1ps детство уже уже изменять взрослый будет
это федеральный государственный образовательный стандарт	это федеральный государственный образовательный стандарт	это poss 3ps государство печать наука, образование
я с она очень согласный	1ps с очень согласие	1ps мнение согласие
можно слепить снеговик	мочь делать шарpl шарpl	мочь делать <dact> шар pl
я думать что такой курс давать глухой новый возможность	1ps думать что курс давать глухой новый возможность	1ps думать что курс давать новый возможность для глухой
в-третьих это огромный количество энергия который обрушиваться на мы и мы не знать куда он потратить	третий еще это большой clf clf.поступление clf.энергии	третий еще это большой clf clf.поступление clf.энергии электричество это множественный clf clf.поступление clf.энергии 1ps тратить куда трудно
мой учитель сказать женщина у она дочь со сломать позвоночник что это не причина отказываться от радость плакать не нужно	poss 1ps учитель <dact> женщина у она дочь со сломать позвоночник <dact> это	мой учитель имя дактилирование 3ps был сказать у 3ps был дочь с позвоночник сломаться 3ps говорить это н-е причина н-е радоваться плакать не
в магазин нет сыр	магазин <dact> нет2	магазин <dact> нет2
не предлагать я ехать	просить уважать 1ps 3ps еда не.нужно	просить уважать 1ps 1ps предлагать 3ps еда не.нужно
общий представление о белок жир и углевод мы мочь получать в лаборатория однако у мы в организм весь устраивать намного интересный и сложный	общий лаборатория о белый <dact> это 1ps внутри.себя все еще интерес	это общий мочь получать только2 лаборатория poss 1ps внутри.себя все еще интересный и сложный
нет хорошо так мой подруга быстро бегать не уметь	не poss 1ps друг быстрый бежать не знать	не poss 1ps друг быстрый бежать не знать
утро принимать два капсула после еда вечер за минута до ужин	утро еда будет еда clf clf.принять clf.	утро еда все4 clf clf.принять clf.две clf.капсулы вечер2 будет еда <dact> з-а <nums> минута будет еда
они бродить до утро по улица а потом поехать на вокзал и снова они место быть рядом	бродить вокзал потом улица пойти и clf clf.два clf	согласиться прогулка с.вечер.до.утро потом вместе clf clf.два clf.человека clf.идут вокзал2 и попадать место сосед
мы не смочь поймать рыба	1ps рыба схватить не мочь	1ps рыба схватить не мочь
у я двое слышать ребенок	1ps двое слышать дети2	1ps у 1ps дети2 <nums> слышащий
мы вс восстанавливать	1ps pl восстанавливать	не.переживать
давать подумать о то что вы написать	нейтр.имп думать о что	поэтому нейтр.имп строчка pl думать
в магазин пойти	магазин	магазин пойти
они собираться и общаться на жестовый язык	indx собираться и общаться жестовый.язык	3ps собираться проводить говорить.на.жестовом.языке
я только русский и английский язык	1ps <nums> русский английский	1ps <nums> русский английский 2
следующий тот кто не знать жестовый язык	следующий2 кто жестовый.язык не.знать2	следующий2 кто жест не знать
я быть в италия	италия2 1ps был	италия2 1ps был
саша сломать нога из-за это сегодня не прийти на день рождение	<dact> сломать нога это сегодня2 не.хотеть день рождение	<dact> <dact> сломанный это 3ps не мочь приезжать день.рождения clf clf.человек clf.прийти день.рождения
жизнь закалять и я благодарный весь кто поддерживать я в непростой время помогать подсказывать	жизнь 3ps учить2 1ps благодарение все кто был сосед 3ps поддерживать 1ps	жизнь 3ps учить2 1ps 1ps благодарение все кто был сосед 3ps поддерживать 1ps 1ps тяжелый время 3ps подсказывать 1ps
да раз в неделя заниматься	<nums> раз <nums> неделя будет	indx неделя <nums> раз <nums> учиться
здравствовать	здравствуйте	приветствовать здравствуйте
я она слушаться потому что считать что она становиться я мама я она даже так называть	1ps думать 3ps девочка 1ps тоже мама 1ps тоже мама иметь тема <dact>	1ps согласиться надеяться <dact> <dact> poss 1ps мама тоже 1ps иметь тема <dact>
еще когда человек полностью задыхаться мы останавливаться	еще когда человек полный задыхаться 1ps останавливаться полный тихий	еще когда человек полный задыхаться2 останавливаться полный тихий
совсем отрицательно	следующий3 совсем отрицать	следующий3 совсем отрицать
здесь мы также продолжать заниматься в различный кружок проводить тренинг и разнообразный мастер-класс	здесь тоже продолжать разнообразие кружок разнообразие мастер класс	здесь тоже продолжать разнообразие кружок мастер класс <dact> разнообразие
либо родитель не отдавать все себя ребенок и не объяснять смысл слово на жестовый язык	или родной отдавать.всего.себя говорить на жестовом языке рассказ	или родной отдавать.всего.себя говорить на жестовом языке рассказывать мысль слово
к сожаление не весь семья такой дружный	сожаление все семья такой дружба	сожаление все семья такой дружба
я не мочь ты отпускать поэтому я купить билет до твой город	1ps 2ps свобода не мочь 2ps кормить билет до poss 2ps город	1ps 2ps свобода не мочь 1ps кормить билет до poss 2ps город
только вы так странно одевать	одежда3 просматривать одежда3 странный	одежда3 просматривать одежда3 странный
где-то или месяц	месяц <nums> месяц <nums> месяц 3	месяц <nums> месяц <nums> месяц <nums> месяц 3
вода в речка быть прозрачный так что можно быть увидеть камень на день	вода река прозрачный видеть камень четко	вода река прозрачный видеть камень четко
у мы с другой быть секрет друг от друг	1ps друг вдвоем секрет ноль	1ps друг вдвоем секрет иметь делить ноль
у я в план в дальнейший объявлять о возможность проведень курс обучение	1ps есть план 1ps ранее объявлять о учиться это обучать2	у 1ps есть план 1ps уже ранее объявлять о poss 1ps план обучать2 <dact> обучать2
весь человек разный у весь разный работа и характер разный то что я объяснять это не готовый формула успех главное я давать вы правильный направление	человекpl разный работать2 разный характер разный характер разный2 1ps объяснять	человек pl разный работать2 разный характер разный поэтому 1ps объяснять это готовый2 успех все4 1ps выполнять главный направление правильный clf clf.двигаться clf.в clf.направлении
нужно что-то решать но я действительно не знать с что начинать	думать решать действительно 1ps не.знать что что начать	думать решать нужно действительно 1ps не.знать что с что начать
мы договариваться встречаться в определенный день я приходить рассказывать о свой проект и сказать что деньги пока на он нет	1ps pl встречаться группа день приходить 1ps рассказывать 3ps собственный проект 1ps деньги	1ps договор число попадать 1ps <dact> приходить это встречаться 1ps разговаривать2 да согласие 1ps что проект 1ps есть а деньги временный нет2 1ps желание <dact> <dact> деньги зависеть
я не понимать математика	математика 1ps не понимать нет3	математика 1ps не понимать нет3
неполный блокада дыхательный путь	н-е полный не останавливаться дышать	н-е полный не останавливаться дышать
наверное вы подумать что быть лишний окошко	наверное думать еще лишний	наверное думать еще лишний
настоящий	настоящий	настоящий
бабушка и дедушка родитель папа а мама и папа родитель катя и антон	бабушка2 дедушка родитель папа родители папа родители <dact> <dact>	бабушка2 дедушка это родители папа poss 3ps мама папа родители poss 3ps <dact> <dact>
еще он замечать бабочка медвежонок никогда не видеть ничто такой же яркий разноцветный красивый и удивительный	еще замечать бабочка2 медведь видеть никогда похоже яркий	еще замечать бабочка2 раньше медведь видеть никогда похоже яркий цвет разный и красивый удивительный
весь животное в лес смеяться над мышонок	все животноеpl лес2 смеяться	все животное pl лес2 смеяться угрожать2 <dact> мышь2
мелкий	мелкий2	мелкий2
они связываться со спонсор который попросить предоставлять скидка или раздавать мыло бесплатно чтобы ребенок использовать он для мытье рука	уже контактироватьpl спонсор контактироватьpl <dact> просить 3ps скидка или бесплатн	уже контактировать pl <dact> спонсор контактировать pl просить 3ps скидка или бесплатный раздавать мыло сдать pl дети2 умыть руки использовать pl уже
следующий акселератор	следущий3 <dact>	следущий3 <dact>
общий	общий	общий
мой попугай любить человек	poss попугай любить человек	poss попугай <dact> любить человек pl
акцентировать внимание именно на это	акцентировать.внимание дети2	<nums> до у 1ps 1ps интерес акцентировать.внимание дети2
вот и первый рыбка ерш	первый рыба2 ловить ерш	первый рыба2 ловить <dact>
мой бабушка любить гулять ночь	poss бабушка любить гулять ночь	poss бабушка любить гулять ночь
получаться что один апсула с утро уменьшать аппетит особенно тяга к сладкий защищать от развитие метаболический синдром инсулинорезистентность а в дальнейший сахарный диабет усиливать эффект насыщение и защищать от повторный набор вес	успех капсула утро уменьшать2 еще не.хотеть отдельный	успех капсула утро indx уменьшать2 следующий3 еда еще не.хотеть отдельный2 сладкий indx желание нет2 и защищать о-т о-т воспринимать и сахар <dact> конец и сильный увеличивать чувствовать сытый и защищать о-т обратимый вес увеличивать
я обожать что в мой работа нет однообразие всегда разный место человек информация посещать разный мероприятие	1ps обожать2 однообразно всегда2 разный место человекpl информация разный посещать	обожать2 что 1ps однообразно так нет2 всегда2 разный место человек pl информация разный посещать.туда.сюда разный
антон настоящий старший брат он всегда защищать свой маленький сестра если кто-то в школа иногда пытаться е обижать	<dact> настоящий старший брат 3ps всегда защищать свой маленький сестр	<dact> настоящий старший брат 3ps всегда защита свой маленький сестра забота случай что школа быть pl 3ps кто обида дразнить
и я становиться интересно быть ли подобный в москва	1ps давно будет интересный был москва	1ps интересный москва здесь есть отсутствие
человек не носить это платье потому что оно мало	человек платье не.нужно потому что 3ps меньше	человек pl н-е носить это платье почему это indx мало маленький3
здесь африка	здесь африка2	здесь африка2
мочь быть чтобы деньги оставаться на потом но на самый дело весь человек разный и у каждый быть свой причина	мочь быть что думать деньги оставаться желание н-о так	мочь быть что думать копить оставить желание н-о так 2ps pl человек pl разный причина свой pl внутрь
мучение	страдание	страдание
тонкий	clf clf.тонкий	худой2
да	д-а	да
в интернет быть список конкурс в свой город	интернет список соренование свой город	интернет список соренование свой город
рано быть такой автомобиль красивый длинный с олень на капот	это indx красивый clf clf.длинный clf.автомобиль <dact> олень clf	<dact> раньше красивый clf clf.длинный clf.автомобиль clf clf.фары <dact> олень clf clf.олень clf.лапы clf clf.олень clf.стоит
она начало что-то говорить да неожиданно замолчать	начинать что случай 3ps говорить случай неожиданно2 молчать	3ps <dact> девочка рассказывать случай неожиданно2 молчать
несколько год назад у она к сожаление умирать мама	несколько лет назад2 девочка poss 3ps мама смерть	несколько лет назад2 девочка poss 3ps мама смерть жалость
пожалуйста помогать мы кто если не вы	пожалуйста помогать 2ps кто 2ps если 2ps не.будет	1ps просить 2ps помогать 2ps 1ps если 2ps кто дефицит
у мы весь переводчик первый категория и постоянно повышать свой квалификация	1ps переводчик все первый и всегда расти карьера учить карьера все	у 1ps переводчик все первый <dact> и всегда расти карьера учить карьера всегда
он быть старый я на год и наш отношение быть довольно странный	о-н был старший 1ps н-а <nums> лет и взаимоотношения был	мальчик 3ps был старший 1ps н-а <nums> лет и взаимоотношения был странный
человек говорить не мочь но он модевать покачать голова	человек говорить не.мочь.сделать голова как голова хорошо	человек говорить не.мочь.сделать голова как голова кивать хорошо
невозможно	невозможный	невозможный
правильно	правильный	правильный
код собираться вперемешку	<dact> собираться смешанный	кода собрание смешанный
он так бояться	о-н так страх	о-н так страх
я подумать у я получаться резьба заниматься	1ps думать у 1ps будет резьба2	поэтому 1ps думать резьба2 успех как
в будущее мир глухой исчезать или нет	будущее мир2 глухой исчезновение будет или не.будет	думать будущее мир2 глухой исчезновение будет или не.будет
это не мой тема но я смотреть немного в будущее	это не poss 1ps тема но 1ps смотреть чуть-чуть будущее	это н-е poss 1ps тема но 1ps смотреть чуть-чуть будущее
это прекрасный возможность для человек с различный ментальный заболевание кто действительно не мочь трудоустраиваться и он нужно постоянный сопровождение	это отличный возможность для человекpl разныйpl умственный заболевание кто не	это отличный возможность для человек pl разный pl умственный заболевание кто не мочь разделять не мочь трудоустройство 3ps нужно следующий следить
множество человек	множественный человекpl	множественный человек pl
не понимать почему кушать что	не понимать почему еда что	2ps не понимать почему еда что
похоже откусывать сэндвич	<dact> тоже	похоже <dact> clf clf.сэндвич clf.откусить
и вот изображение стекло запотевать он начинать он протирать и когда протирать начинать проявляться картина то что он хотеть	птица2 новый потом начинать вытирать когда2 начинать картин	пример clf clf.изображение clf.размытое начинать вытирать когда2 вытирать появляться картина рисовать это соответствовать indx что 3ps желание похоже 1ps исправлять 3ps
также здесь рассказывать об история общество глухой о то откуда возникать жестовый язык	похоже история общество глухой <dact> возникать	и 3ps включать похоже 1ps рассказывать 2ps история раньше глухой общество жестовый.язык2 возникать
если не помогать снова производить хлопок пока ни получаться	если н-е 1ps помогать 3ps новый производить хлопок пока поймать	бесполезный новый clf clf.человек clf.выбить clf.инородное clf.тело clf clf.человек clf.выбить clf.инородное clf.тело чередовать глаза clf clf.инородный clf.предмет clf.вытолкнуть нужно
когда медвежонок просыпаться папа не быть только вода повсюду	медведь просыпаться папа не был только вода повсюду	когда медведь маленький3 проснуться папа пусто повсюду вода
получаться при минимальный увеличение жир обмен вещество в организм замедляться в раз	получаться clf clf.чуть увеличение <dact> <dact> clf clf.огранизм	получаться clf clf.чуть увеличение <dact> увеличение clf clf.чуть получаться clf clf.огранизм clf.процесс <dact> медленно в 1.5 <dact> медленно
я переводить различный пара мероприятие	1ps переводчик разный урок мероприятие	1ps переводчик разный урок мероприятие
а к кто обращаться	а обращаться кто	а обращаться кто
я обязанный знать военный дело	1ps обязанность знать правила военный дело	1ps обязанность знать правила военный дело
древолаз очень токсичный и бывать разный цветок желтый темно-зеленый красный черный но самый опасный золотой	clf clf.лягушка clf.взбирается clf.по clf.	clf clf.лягушка clf.взбирается clf.по clf.дереву у 3ps есть вредить есть бывает видеть цвет3 желтый темный зеленый красный синий черный н-о сам2 опасный зеленый цвет3 золотой
вопрос кто входить в сообщество глухой	вопрос кто входить мир2 глухой	вопрос кто включать мир2 глухой внутри
четвертый ваш мнение	четвертый poss 2ps мнение	четвертый poss 2ps мнение
веко защекотать слезинка когда поезд тронуться но вдруг дверь в купе открываться и входить роберт	слеза поезд clf clf.поезд clf.трогается clf.поезд	слеза поезд clf clf.поезд clf.трогается вдруг clf clf.двери clf.купе clf.открываются мальчик clf clf.человек clf.идет то.же.самое <dact>
создавать	создавать	собирать
а куст кричать соловей чтобы тот еще крепко прижиматься к шип	кусты clf clf.кусты кричать птица2 imp держать clf	кусты clf clf.кусты кричать птица2 imp держать clf clf.тельце clf.птицы imp
мочь быть у вы быть какой-либо вопрос или хотеть подробность я готовый вы отвечать спрашивать	мочь быть у ps2 есть вопрос подробный мочь ответ спросить 1ps	может.быть у ps2 есть вопрос подробный мочь ответ спросить 1ps
нападать	нападать	напатать
из жир так же как и из белок строиться клетка оболочка мембрана без жир не образовываться поэтому часть жир идти на строительство этот мембрана и не давать мы энергия	<dact> тоже строить клетки.организма <dact> и-з <dact> это отдельный	<dact> indx и <dact> тоже строить клетки.организма indx без clf clf.оболочка clf.клетки это делать и-з <dact> это отдельный <dact> будет использовать строить clf clf.оболочка clf.клетки и электричество 3ps давать 1ps нет indx половина убирать
сделать такой ступенька на память красота	делать такой ступенька н-а память красивый	это indx ступенька был собирать памятник красивый
быть много направление где можно себя применять физкультура преподавание разный направление быть	1ps физкультура направление где можно применять физкультура преподавание	1ps какой физкультура направление считать3 преподавание направление считать3 любой разнообразие3 куда все есть
а инвалид нужно быть обязательно давать путевка дом отдых специальный больница	и а инвалид нужно платитьpl должен первый путевка отдых дать	и а инвалид так нужно платить pl должен первый путевка отдых дать дом pl отдых дать специальность больница2
мой текущий рабочий деятельность мочь продолжаться до но вдруг я узнавать о болезнь или что-то случаться	poss 1ps деятельность рабочий деятельность мочь быть хорошо мочь быть	сейчас 1ps деятельность работать2 быть хорошо мочь до <nums> мочь быть н-о узнать болезнь что случай
это значит настоящий поэтому сейчас он не мочь	это настоящий сейчас не.мочь	это настоящий сейчас не мочь
поэтому я хотя и оробеть но не до конец и весь продолжать посматривать на ефросинья петровна что же она будет делать далеко	1ps хотеть оробеть не.хотеть н-о вдруг до конец	1ps пока 1ps чуть-чуть страшный чуть-чуть взглянуть бабушка взглянуть делать что интересный взглянуть
по разный причина по сложный работа по ещ какой-то причина просто не хотеть	разнообразие причина сложный работа причина сложный что-то не.хотеть	разнообразие причина сложный условие труд ещё что-то не.хотеть
в сентябрь обычно тоже жарко	сентябрь indx тоже	сентябрь indx тоже
внешний	нормально	внешний
я не знать испанский язык	1ps испания2 язык не знать	1ps испания2 язык 1ps не знать
я относиться ко весь одинаково хорошо	1ps относиться так.далее	1ps все так хорошо отношение
один ребенок будет смотреть но он это не нужно	смотреть не.нужно	смотреть не.нужно
мой профессия интересный и необычный	poss 1ps профессия интересный необычный	poss 1ps профессия переводчик интересный необычный
однажды тамара присниться сон забросить деревня а там дочка и она звать тамара и просить скоро она находить	когда2 <dact> домой indx дочь clf clf.два clf.приближа	и однажды 3ps девочка сон изгой2 деревня и дочь кто кричать мама pl быстрый 1ps успех
в-третьих помимо углевод жир и белок пища давать наш организм витамин и минерал который регулировать различный процесс	третий еда <dact> <dact> <dact> еда это 3ps давать 1ps плюс полез	третий еда <dact> <dact> <dact> вместе еще 3ps давать 1ps плюс полезный <dact> что метаболизм правильно работать внутри.себя все
я должный уметь командовать отряд	1ps должен качественный знать лицо	1ps нужно знать пример группа военный руководить
я часто пропускать школа из-за то что сидеть с младший сестра	1ps часто пропускать школа 1ps тоже сидеть н-о младший сестра	1ps часто прогуливать школа почему 1ps сидеть вместе младший сестра
общий	общий	общий2
что хотеть сказать	что желание сказать	желание сказать
бывать что в связь с погодный условие обледеневать и оборваться провод но опять же такой случаться редко	быть попадать дождь быть clf clf.провод clf.порваться ред	быть попадать <dact> мороз дождь быть clf clf.провод clf.pl провод clf clf.провод clf.порваться редко
так быть всегда сказать сова и это никогда не изменяться	похоже разговаривать2 ладно думать ладно	разговаривать2 <dact> пусть всегда ладно думать изменять не.будет2 ладно
через ассоциация мы постараться сделать так чтобы вы в свой город например в новосибирск находить филиал этот ассоциация и приходить туда	1ps через содружество 3ps адрес список 1ps будет раздавать2 все это 3ps	1ps через содружество 3ps 1ps адрес список 1ps будет раздавать2 все это 3ps адрес свой новосибирск 3ps другой город будет приходить2
а если я не прийти домой папа и мама обязательно сообщать в милиция	1ps домой не будет родители должен полицейский милиция предупредить	1ps домой не будет родители должен полицейский милиция предупредить
лето сам себя нужно купаться	лето обязательный купаться	indx лето обязательный купаться
когда наступать ночь они отдыхать	когда ночь начало отдых	когда ночь начало отдых
это я очень нужно потому что я получать различный информация о музей город благодаря этот организация	1ps indx быть включать 1ps различныйpl получать информация все получать включать indx	1ps indx быть включать это нужда indx различный pl получать информация все получать вечный у 3ps содружество перечислять2 получать2 indx быть музей работать2 включать indx город страна indx 1ps вечный
мать девочка сильно выпивать после развод с отец и оля всегда сторониться ребята чувствовать себя обделять	мама poss 3ps девочка проходить и <dact> 3ps всегда2 <nums> лишний2	мама poss 3ps девочка проходить расстаться папа сильный алкоголь и <dact> 3ps всегда2 <nums> лишний2
вода холодный или ты притворяться	вода холодный или 2ps притворяться	вода холодный или 2ps притворяться
благодаря вот этот механизм ускоряться снижение вес	благодарение это indx indx вес худеть	благодарение это indx собирать indx успех вес худеть
дочка сидеть зажиматься в угол	дочь сидеть угол прятать	дочь сидеть угол прятать
но иногда смотреть на человек и думать что у он жировой запас даже слишком много и пора останавливаться	3ps видеть человек 3ps <dact> жировые.запасы куда не.нужно	видеть человек 3ps <dact> жировые.запасы куда хватит конец
мы с она знакомый	1ps pl девочка знакомый	1ps pl вместе знакомый
я приходить в тот школа в который среди слышать ребенок быть код приходить туда смотреть помогать	1ps приходить2 школа indx включать слышащий дети2 <dact> приходить	кто indx дети слышащий кода включать 1ps помогать 3ps 1ps приходить 3ps проводить indx приходить смотреть indx
обнимать и до следующий встреча	обнимать до следующий встреча	обнимать все до следующий встреча пока
подключаться быть вы ждать	ждать2 2ps подключаться 1ps	ждать2 poss 2ps 2ps подключаться 1ps
вы быть получать различный поручение	желание различный поручать	желание пример поручать различный
я быть учитывать возможность ваш город	1ps будет учить2 возможность poss 2ps город	1ps обучать2 потом потому.что город poss 2ps
также вы мочь находить я в соцсеть ВК фейсбук и написать я задавать вопрос я отвечать	кто узнать2 мочь 2ps соцсеть ответ в-к фейсбук на	кто узнать2 мочь 2ps 1ps соцсеть ответ в-к фейсбук написать вопрос 1ps отвечать
следующий вога клуб глухой	следующий2 <dact> клуб глухой	следующий2 <dact> клуб глухой
я сам глухой общаться на жестовый язык мой родитель а также бабушка и дедушка тоже глухой и мы нормально общаться на жестовый язык	1ps сам2 глухой говорить на жестовом языке poss 1ps родиетли глухой	1ps сам2 глухой poss 1ps говорить на жестовом языке poss 1ps родиетли глухой бабушка дедушка глухой 3ps pl говорить на жестовом языке нормально
если бы я не пойти работать переводчик я бы выбирать направление сурдопедагог и обучать бы ребенок с нарушение слух	если 1ps поступать работать2 переводчик 1ps выбирать 1ps направление <dact> преподавание	если 1ps поступать работать2 переводчик 1ps выбирать другой специальность направление <dact> преподавание обучать2 дети2 нарушение2 слух
да	д-а	д-а
укус лори мочь вызывать анафилактический шок и даже смерть говорить что лори подражать змей ядовитый	<dact> 3ps кусать мочь 1ps вызывать анафилактический шок 1ps смерть мо	это 3ps кусать мочь 1ps <dact> 1ps смерть мочь2 это осторожно <dact> 3ps копировать змея похоже
о нет ты не мочь поехать на королевский бал в такой вид	2ps 2ps не мочь пойти <dact> королевский бал в такой вид	нельзя уезжать королевский праздник бал такой 2ps
мы видеть что человек стоять взгляд испуганный	1ps видеть человек стоять глаза clf clf.глаза clf.расшириться	1ps 1ps видеть человек стоять глаза какой clf clf.глаза clf.расшириться напуганный indx кашлять2 останавливаться
ехать нужно быть далеко но луиза не мочь пропустить такой событие	еда не.нужно н-о indx если просматривать случай	поехать далеко н-о пропускать3 не мочь
семья это труд друг о друг забота	семья это труд друг.друга забота	семья это труд делать друг.друга забота
например на помещение	пример помещение	пример комната комната
на седьмой место муравьед	н-а седьмой место <dact>	следующий3 <dact>
он вчера не купить мясо	3ps вчера мясо покупать не был	о-н 3ps вчера мясо покупать не был
он быть страшно но он стараться не показывать это	о-н был страх н-о стараться н-е показывать	о-н был страх н-о стараться н-е показывать
жир сжигаться быстро и превращаться в энергия	<dact> сжигаться быстрый и превращаться электричество	<dact> огонь быстрый изменение энергия
и как раз когда мы общаться в фейсбука там быть человек по имя аркадий белозовский	<dact> когда2 фейсбука indx был человек имя <dact> <dact>	<dact> <dact> связь когда фейсбук indx был беседовать indx имя <dact> <dact>
по-прежнему пусто	пустой ноль	пустой то.же.самое
у я быть принтер	1ps принтер2 1ps быть	1ps принтер2 иметь
а также углеводный пища потому что повышаться сахар и инсулин в кровь	плюс <dact> еда сахар2 выше <dact> кровь тоже выше	плюс <dact> еда indx тоже почему сахар2 выше <dact> кровь тоже выше
для то чтобы вы быть заразный у вы не должно быть антитело	если 1ps заразный будет у 2ps необходимость внутри защита не иметь	если 1ps заразный 1ps необходимость внутри защита не иметь
мой жена тоже учиться в ЛВЦ она знать	poss 1ps жена лвц учить2 знать лвц знать	poss 1ps жена лвц учить2 знать пример
в это институт учиться глухой и я там быть	институт глухой толпа есть indx indx и indx indx был	институт глухой толпа есть indx это 1ps был indx
код из разный страна сразу узнавать друг друг радоваться начинать взаимодействовать друг с другой	<dact> кода италия2 poss 3ps одинаковый 3ps нейтр.имп радость	глаз знать poss 1ps 1ps пример 1ps италия2 русский пусть <dact> 3ps одинаковый 3ps нейтр.имп радость clf clf.взаимодействовать общаться
следующий этап начинать копить на случай если оставаться без работа увольняться тогда что делать а резерв всегда быть	потом следующий все4 потом начинать копить случай что уволиться что	потом следующий все4 потом начинать копить вдруг 1ps не.работать уволиться что pl делать оставить есть
поэтому хром уменьшать тяга к сладкий	поэтому хром уменьшать2 тяга сладкий	<dact> уменьшать2 3ps тянуть 1ps сладкий
хорошо	хорошо	хорошо
абсорбция другой соединение хром незначительный и составлять мало	<dact> другой соединение хром незначительный clf clf.чуть меньше	<dact> соединение успех мало меньше <nums> процент
за вертолет платить кто будет	вертолет деньги кто будет	вертолет деньги кто будет
почему	почему	почему
у мой брат быть чистый носок	poss 1ps брат чистота носки иметь	poss 1ps брат чистота носки иметь
изменяться мир ваш семья друг и коллега весь изменяться	ваш семья мир изменить другpl вместе работать все изменить будет	ваш семья мир изменить друг pl вместе работать все изменить будет
это агенство вообще мочь выделять переводчик на любой мероприятие вы же знать что вы по закон положенный переводчик поэтому не надо стесняться он просить	это indx это выделить перевод indx любой деятельность что соревнование indx подать.	это indx это выделить перевод indx любой деятельность что соревнование indx подать.заявление и обратиться 2ps перевод пожалуйста обслуживать все терпеть должен закон indx есть все должен обслуживать перевод
получаться я продолжать работать и плюс обучать студент будущий переводчик	1ps работать2 оставаться2 продолжать работать2 оставаться2 плюс 1ps 	1ps получать2 1ps продолжать работать2 оставаться2 продолжать еще работать2 плюс 1ps учить студент2 будущее переводчик
гордиться	гордый	гордый
вдруг ларсить замечать вдалеке свой папа	случай <dact> замечать	случай <dact> замечать clf clf.вдалеке indx папа видеть
следующий рыба фуга большой круглый рыба с пятно	изменить.направление рыба2 <dact> clf clf.рыба clf.круглая	изменить.направление рыба2 <dact> clf clf.рыба clf.круглая пятно pl clf clf.рыба clf.круглая
говорить голос и жест одновременно	говорить на жестовом языке время	жестовый язык
привет	привет	привет
это специальный группа слышать ребенок у который родитель глухой	это специальность группа дети2 слышащий poss 3ps папа глухой	это специальность группа дети2 слышащий poss 3ps папа глухой
верно	правильный	правильно
во-первых в состав максимально эффективный комлпекс компонент экстракт гарциния и пиколинат хром	первый собирать indx есть тупик полезный общий <dact> и <dact>	первый собирать indx есть тупик полезный общий <dact> и <dact>
она входить вытирать рука о полотенце	clf clf.открыть clf.рука о полотенце	clf clf.человек clf.идет потирать.руки
вдруг он услышать в лес возмущать разговор зверь медведь заяц белок птица	слышать indx лес разговаривать2 лес возмущаться заяц <dact> 	слышать indx лес что разговаривать2 <dact> что indx был разговаривать2 медведь возмущаться заяц <dact> птица множество смешанный
молчать	молчать	молчать
что за надоедливый крыса что ты нужно	что задание надоедливый крыса	случай крыса2 вредный что желание
например масло коллаген и то что иметь глубокий увлажнение чтобы ухаживать за волос	пример масло ухаживать глубоко масло <dact> что был	пример масло ухаживать глубоко масло <dact> заботиться что был
я белый мишка с северный полюс	1ps белый clf clf.извиваться северный.полюс	1ps белый медведь жизнь северный.полюс
приходить посмотреть дом рядом с лес там жить мальчик который играть в лес	приходить2 смотреть2 рядом рядом <dact> indx мальчик жизнь indx территория indx	приходить2 смотреть2 рядом дом indx мальчик жизнь территория близко <dact> indx indx мальчик был indx дерево pl игра
нужно поставлять ряд задача написать устав	нужно ряд задача написать устав	нужно поставить pl список задание pl <dact> список список <dact> закон
чужой	чужой	чужой
у я в голова не укладываться вообще вот такой вот случай быть	1ps 1ps тупик ап попадать был	1ps 1ps тупик ап попадать случай был
сделать маленький десятисекундный репортаж и показывать	маленький4 <nums> секунда отправлять 3ps новости показывать	видео2 маленький4 <nums> секунда отправлять 3ps новости показывать
запираться	выключить	выключить
скоро вс починять	скоро чинить будет	скоро чинить готовый будет
следующий лебедь очень красивый птица который жить пара и с который у мы связанный много представление о любовь	следующий3 <dact> птица2 clf clf.птица clf.машет	следующий3 <dact> clf clf.птица clf.машет clf.крыльями clf clf.длинная clf.шея красивый clf clf.два clf.лебедя clf.склонили clf.друг clf.к clf.другу clf.головы всегда2 clf clf.два clf.лебедя clf.склонили clf.друг clf.к clf.другу clf.головы милый видеть всегда2 внутри любовь2 clf clf.два clf.лебедя clf.склонили clf.друг clf.к clf.другу clf.головы clf clf.птица clf.машет clf.крыльями
и я весь время поглядывать на ефросинья петровна	1ps всегда2 видеть пожалуйста 1ps еда <dact>	1ps всегда2 видеть взглянуть бабушка 3ps делать что
я показывать презентация	1ps показывать мультимедийная.презентация	1ps показывать мультимедийная.презентация indx
привет я звать елфимов светлана вот мо жестовый имя	приветствовать 1ps имя <dact> <dact> poss 1ps жестовое.имя sn	аплодисменты 1ps имя <dact> <dact> poss 1ps жестовое.имя sn
сейчас жестовый язык популярный в мир слышать	сейчас3 жестовый.язык2 популярный мир2 говорить	сейчас жест известный indx мир говорить
соглашаться	согласие	согласие
в Instagram быть группа мама в дело	видео2 indx мама группа был	в instagram 1ps есть группа мама дело indx
даже к подросток нужный другой подход	даже подросток переезд средний другой подход будет	даже подросток переезд средний2 другой работа будет
например я работать в технологический музей видео гид и у они там очень хороший финансовый положение	пример 1ps технология музей делать видео <dact> indx финансирование2 лучше	пример 1ps делать технология музей и indx поручать видео <dact> indx финансирование2 лучше
перечить она не сметь	перечить	перечить
следующий жестовый пение театр глухой история или рассказ на РЖЯ	следующий2 жест пение театр жест <dact> или рассказ жест пример	следующий2 жест пение театр глухой poss 3ps история жест рассказ <dact>
ребенок не осведомлять об это почему	ребенокpl осведомлять почему	3ps pl не знать почему
оказываться очень важный знать что у он быть друг	оказываться очень важный если у 3ps есть друг	оказываться очень важный если знать у 3ps есть друг
что нужно делать	что нужно делать	что делать нужно
привет	привет	привет
или написать свой мнение	или написать poss 2ps мнение	или poss 2ps pl мнение написать
это подходить то кто хотеть но не мочь копить	это кто желание н-о не.получаться копить подходящий объясн	есть кто желание н-о не.получаться копить подходящий объяснять
смерть дорогой цена за красный роза восклицать соловей	смерть дорогой цена задание красный цветок кричать птица2 крыло	смерть дорогой clf clf.вносить clf.деньги обмен2 красный цветок отвечать птица
отражение роза в серебряный зеркало отражение роза в недвижный вода вот каков быть роза расцветать на верхний побег куст	отражение птица2 золото зеркало отражение птица2 недвиж	типа река отражение цветок нежный сиять так2 нежный светлый был цветок расти кусты clf clf.цветок clf.распукается clf.медленно
вопрос как вы относиться к инклюзивный образование когда глухой и слышать учиться вместе	вопрос инклюзия образование2 говорить глухой относиться как	вопрос инклюзия образование2 говорить глухой вместе poss 2ps относиться как
и самый сложный это сам человек	сам2 сложный это человекpl сам2 сложный	сам2 сложный это человек pl сам2 сложный
старый солдат идти в отпуск	старый солдат идти отпуск	старый солдат идти отпуск
следующий зима	следующий2 зима	следущий весна
нормально весь	нормально	нормально
восхищаться	восхищаться	восхищаться
у слышать билет стоты дорогой	дорогой2 слышащий билет	у слышащий стоимость деньги больше
и что же теперь делать раз нет	и разный2 что делать	отсутствие pl что делать
ах какой счастие восклицать он	счастье какой счастье кричать	счастье какой счастье кричать
